sweat	They hid from the gunman in a sauna where they could sweat it out .
saving	Wal - Mart isn ' t the only saving place !
sting	Can honeybee abuse lead to a sting operation ?
entrenched	A ditch digger was entrenched in his career .
forge	She was only a Blacksmith ' s daughter , but she knew how to forge ahead .
hit	Did you hear about the new pinata ? It ' s a huge hit .
vault	A bank manager who was also a high jumper spent most of his time in the vault .
deep	A discussion of digging a new mine shaft was too deep for him .
pin	She was suspected of stealing a brooch but they couldn ' t pin it on her .
licked	Once ice cream was invented the problem was licked .
admitted	' ' There ' s room for one more , ' ' Tom admitted .
toasted	They threw a party for the inventor of the toaster . And he was toasted .
manager	If you ' re a gardener you might call yourself a ' plant manager ' .
squares	My advanced geometry class is full of squares .
grave	Jesus changes grave situations . Happy Easter .
outlet	I got angry when my cell phone battery died . My counselor suggested I find an outlet .
draw	A cowboy who was also an artist could draw fast .
snorted	' ' Angel dust ? Me ? Never touch it ! ' ' Tom snorted .
burning	The fire chief was always asked burning questions .
retire	OLD MECHANICS never die they just retire
gut	Some diets cause a gut reaction .
spell	If you leave alphabet soup on the stove and go out , it could spell disaster .
bounce	OLD BUNGEE JUMPERS sometimes die but they can still bounce back
shot	The gunman took a shot at new opportunities .
Sandy	My name is Sandy , I just hang around the beach .
gushed	I ' ve struck oil ! Tom gushed .
raft	Getting rid of your boat for another could cause a whole raft of problems .
John	My name is John . I ' m a plumber
coached	' ' Pretend we were in the days before railways , ' ' Tom coached .
NP	OLD STATISTICIANS never die , they just get broken down by age , sex and marital status .
levels	Did you hear about the crime that happened in a parking garage ? It was wrong on so many levels .
space	Two astronauts who were dating put an end to it because they both needed their space .
case	Luggage salespeople have to make a good case for you to buy .
NP	A kettle on the stove was singing ' Home on the Range ' .
parts	Musical mechanics always sing in parts .
focus	Hubble wanted to bring the idea into better focus .
groundbreaking	The decision to begin construction on the Empire State Building was a groundbreaking historical event .
cover	OLD QUILTERS never die , they just go under cover .
taste	When cannibals ate a missionary they got a taste of religion .
fret	OLD GUITARISTS never die , they just fret their lives away
still	One evening King Arthur ' s men discovered Sir Lancelot ' s moonshine whiskey operation and shattered the still of the knight .
lies	He stole an invention and then told patent lies .
see	I made a batch of fish eye soup , it should see me through the week .
foot	When he kicked the invoice , it didn ' t mean he wanted to foot the bill .
bottom	Even though the well was a mystery to her , she didn ' t want to get to the bottom of it .
irrational	Old math teachers never die , they just become irrational .
landing	Careless stair dancers are heading for a heavy landing .
vacate	OLD LOGICIANS never die , they just vacate the premises .
bar	Lawyers have to like alcohol because they ' re always being called to the bar .
bat	Baseball players are expected to perform well right off the bat .
wind	Vines are extremely short - tempered . They snap at the slightest wind .
sprinkles	The man brought an umbrella with him into the ice cream store because he heard there was a chance of sprinkles .
faculties	OLD ACADEMICIANS never die , they just lose their faculties
snappy	Bring me a rubber band and make it snappy !
energy	An electric company is always looking for high energy employees .
quickly	When a thief stole several volumes from the library he was quickly booked .
friends	The inept mathematician couldn ' t count on his friends .
rest	The phone call interrupted my nap , and I never did get the rest .
crunch	When potato chips don ' t sell fast enough , the maker knows it will soon be crunch time .
spouted	Save the whales , spouted Tom .
boot	OLD HIKERS never die they just get the boot .
Sunday	Come in for a free makeover this Sunday
rejoined	Superglue ! Tom rejoined .
corrected	Admitting a mistake : ' ' Like the orthopedist ' s patient , I stand corrected . ' '
records	For every 45 I collected , I would write down the song and the artist so I could keep records .
pat	' ' There , there , ' ' was Tom ' s pat answer .
match	A contest held by fire fighters is called a ' match ' .
hell	No one chills out in the fires of hell .
root	A lot of trees were dying , but they needed to figure out the root of the problem .
turbulent	OLD PILOTS never die , they just get more turbulent .
manager	A guy became so good with a chainsaw that he was promoted to branch manager .
blow	Don ' t argue with a bomb inventor - he might blow up at you .
knees	Don’t let adversity get you down unless you are on your knees
box	She was only a Wrestler ' s daughter , but you oughtta see her box . .
unhinged	OLD DOOR FRAMERS never die , they just become unhinged .
much	I was against the construction of tennis courts in the park as I thought they would cause too much racket .
croaked	I ' m dying , Tom croaked .
picking	In a recession , the most secure job is garbage - man . Business is always picking up .
flier	Wilbur Wright said he ' d take a flier on it .
fee	A man brought his retriever to the vet for some tests and had to pay a lab fee .
game	They replaced the baseball with an orange to add zest to the game .
boring	If you operate a drill press you have a boring job .
rut	Figure skaters don ' t like to be in a rut .
months	A thief who stole a calendar got twelve months .
type	OLD PRINTERS never die they ' re just not the type
cue	A play , based on billiards , started right on cue .
potty	My father slept under the bed , I think he was a little potty .
grind	Is coffee your daily grind ?
Alarming	Some people find fire drills quite Alarming .
differentiate	Old math profs never die , they just can ' t differentiate .
see	The inventor of glass decided to see it through .
possessive	A noun and a verb were dating but they broke up because the noun was too possessive .
NP	Hell ! . . . I’d forgotten about that !
curves	She was only a Pitcher ' s daughter , but you should have seen her curves .
pitch	A baseball player can sell himself to a new team if he has a good pitch .
bristled	' ' Use your own toothbrush ! ' ' Tom bristled .
Bill	My name is Bill . I run a collection agency
dough	OLD BAKERS never die , they just stop making lots of dough .
age	The couple grew fruit trees and lived to a ripe old age .
drain	The plumber had to quit his job because it was too much of a drain .
calculus	Finding area is an integral part of calculus .
pitch	If you sing while playing baseball , you won ' t get a good pitch .
dole	OLD PINEAPPLE GROWERS never die , they just get on the dole .
General	Some commands given by the army are specific , others are General .
stable	If a horse could predict the weather , it would probably say that the weather is stable .
warm	She was only a Weatherman ' ' s daughter , but she sure had a warm front .
derailed	OLD LOCOMOTIVE ENGINEERS , never die , they just get derailed
shots	A doctor who became a bartender was always giving out shots !
average	OLD STATISTICIANS never die , they just average out .
show	A little boy fired his light - colored crayons because they wouldn ' t show up .
register	With certain cashiers , things are slow to register .
contact	OLD ELECTRICIANS never die they just lose contact .
might	' ' Perhaps I will , ' ' said Tom with all his might .
material	The comedian stopped at the fabric store on his way to a comedy gig . He was looking for new material .
taxi	- Call me a taxi . - OK , you ' re a taxi .
pawn	Someone who sells old chess pieces is a pawn broker .
bombshell	The model who joined the air force was a bombshell .
pipe	OLD PLUMBERS never die , they just pipe down .
fly	The surgeon really did not know how to perform quick surgeries on insects , but he did one on the fly .
mean	OLD STATISTICIANS never die , they just get mean .
hoot	We went to the owls convention and it was a real hoot .
deflowered	OLD GARDENERS never die they are just deflowered .
vent	In the air duct installers union they have lots of opportunity to vent .
cut	He and his partner made knives , and they shared a cut .
steal	A baseball player was a thief . He was always trying to steal .
splitting	The fault line had a splitting headache .
flop	OLD DIVERS never die , they just flop .
stage	For a while , Houdini used a lot of trap doors in his act , but he was just going through a stage .
veins	OLD MINERS never die , they just lose their veins .
tender	Animals are slaughtered for meat at a tender age .
mail	' ' I make the armour out of chain links , ' ' Tom replied by mail .
blast	He became an astronaut and had a blast .
swept	A janitor with a broom in hand swept her off her feet .
clicked	I couldn ' t figure out how to fasten my seatbelt . Then it clicked .
focus	OLD PHOTOGRAPHERS never die , they just lose their focus .
net	The trapeze artist had to buy his own safety equipment . Every Friday he drew his net wages .
cavity	Dentists on death fill their last cavity .
problems	Math class is full of drama . There are so many problems to work out .
bone	Her exam was on the human skeleton , so she decided to bone up .
chicken	The first duck wouldn ' t go in the water . The other duck said ' ' What are you , chicken ? ' ' .
drive	To golf at your favorite course may require a long drive .
identities	OLD TRIGONOMETRY TEACHERS never die , they just lose their identities .
bounce	She was only a Catcher ' s daughter , but she had many balls bounce off her chin .
NP	Jesus did the only extreme world makeover , the flood
point	I took up teaching fencing as I wanted my students to get the point .
shorts	Sign on an electrician ' s truck : Let us remove your shorts .
NP	I like marching songs , in any month .
recounted	' ' I couldn ' t believe there were 527 , 986 bees in the swarm ! ' ' Tom recounted .
hitch	Our Boy Scouts ' knot - tying class went off without a hitch .
NP	I used to have a fear of hurdles , but I got over it .
pop	A group called the Balloons sings pop music .
remarked	' ' I have to check the score on this exam again , ' ' Tom remarked .
rakes	She was only a Gardener ' s daughter , but she knows all the rakes .
Combination	A locksmith has to have a good Combination of skills .
arms	The teacher asked a question and the students were all up in arms .
lot	She was only a Real estate agent ' ' s daughter , but she gave a lot away .
flies	When you ' re wearing a watch on an airplane , time flies .
functioned	The mathematician worked at home because he only functioned in his domain .
legs	I couldn ' t stand to be without my legs .
dough	Old bakers never die , they just keep making lots of dough .
root	In equations with square numbers I can never find the root of the problem .
right	Did you hear about the guy whose whole left side was cut off ? He ' s all right now .
places	Airline pilots make many friends in high places .
still	OLD MOONSHINERS never die , they just keep still .
cut	His business plan to manufacture scissors just didn ' t cut it .
nailing	The carpenter was well - known for nailing his work .
alarmed	Salespeople selling security equipment like to see people get alarmed .
around	She was only a Globetrotter ' s daughter , but she manages to get around .
kid	We’ve got children’s church because we know how to kid around
boils	What it boils down to is this : eggs taste good .
Chuck	My name is Chuck , I ' m a butcher .
Mass	The pope , on his 2008 tour in the United States , skipped Mass .
bear	There was a massive outcry against the plan to build a power line across a nature preserve . The public couldn ' t bear the tension .
suit	A tailor sometimes decides to suit himself .
crowning	A woman who became queen considered it her crowning achievement .
mass	Even though Catholics in space are weightless , do they have mass ?
buzz	OLD PILOTS never die , they just buzz off .
committed	Convicts are committed people .
Emmy	My name is Emmy , I ' m a T . V . star
sweeping	A new type of broom came out , it is sweeping the nation .
uprooted	OLD TREE SURGEONS never die , they are just uprooted .
mouthful	Pills with long names can be quite a mouthful .
Brooks	My name is Brooks . I ' m an irrrigation consultant
slip	A lingerie thief gave a police officer the slip .
multiply	We ' ll never run out of math teachers because they always multiply .
scratched	The race dogs got a bad case of the fleas - they had to be scratched .
retainer	A lawyer asked his dentist to give him a retainer .
Wade	My name is Wade and I ' m in swimming pool maintenance .
gravity	An astronaut who fails on a weightlessness experiment must be aware of the gravity of the situation .
flake	The weatherman who forecasted snow in July was a bit of a flake .
ghost	Two brothers collaborated on haunted stories , but one was a ghost writer .
falling	They built a tree house together but then had a falling out .
tree	I ' m a sap for tree jokes .
boot	OLD COWBOYS never die , they just get the boot .
bucks	Cowboys in a rodeo can be sure to get a few bucks .
faculties	OLD PRINCIPALS never die they just lose their faculties .
NP	Never lie to an x - ray technician . They can see right through you .
empire	He bought a rope factory to tie into his empire .
spike	He took a nail to the volleyball game because he wanted to spike it .
encapsulating	Pharmacists find their work to be very encapsulating .
punch	OLD KEY PUNCH OPERATORS never die they just punch out .
dribble	A basketball player couldn ' t control his saliva but he could sure dribble .
log	If you work in a forestry company you will probably have to log your time .
putter	OLD GOLFERS never die they just putter away .
tips	A job circumcising elephants isn ' t so bad . The base salary is small but the tips are big .
wax	A man giving a speech by candle - light can wax eloquent .
bat	I never have understood how you ' re supposed to hit anything with a bat . . . . . it keeps flying away .
NP	' ' How long will I have to wait for a table ? ' ' asked Tom without reservation .
overboard	The designer wondered why his pirate room wasn ' t perfect , and the judge told him he went a little overboard .
stock	' ' Consult an investment broker , ' ' was Tom ' s stock answer .
judge	If there ' s one person you don ' t want to interrupt in the middle of a sentence it ' s a judge .
hops	Rabbits like their beer brewed with a lot of hops .
Sly	My name is Sly . I ' m a detective .
fan	Some people really enjoy blowing air out of their lungs - I ' m not a fan myself .
seasoned	An old spice wholesaler is a seasoned veteran .
retail	If an animal looses its tail it should shop at a retail store .
impression	If you go for a job interview at a rubber stamp company try to make a good impression .
spark	OLD BLASTING TECHNICIANS never die , they just lose their spark .
mold	Studying fungus is a way to mold young minds .
tuning	A mechanic who was also a musician was good at tuning things .
bets	A gambling gardener usually hedges his bets .
chick	I watched a movie about a baby hen , it was a real chick flick .
shuffle	How does a card player party ? They shuffle .
relight	I noticed that the sun was out , and nobody had bothered to relight it .
dense	If a town ' s people have low IQs is the population dense ?
NP	Doctor , Doctor , you ' ve got to help me . I think I ' m a kleptomaniac . - Don ' t worry . I think there ' s something you can take for that . Next .
peach	She was only a Fruit vender ' s daughter , but , oh , what a peach .
expressions	Old math profs never die - - they just use strange expressions .
marooned	A boating accident between the yacht , Red Dawn , and the schooner , Blue Lagoon , left the survivors marooned .
NP	Junior loved being a member of the wrestling team even though he was prone to lose .
naked	The waiter was shocked when I asked for my salad to be served naked . I explained , no dressing please .
blow	I suspected our new house guest was a terrorist . He asked to sleep on a blow up mattress .
plaque	Trophy shops often will give customers floss with their purchase to eliminate plaque problems .
scratch	Scientists have created a flea from scratch .
deflowered	OLD BOTANISTS never die , they ' re just deflowered .
shallow	The plot to his story of the pond was quite shallow .
fluke	If you sight a whale , it could be a fluke .
account	A person who would make a banking joke is of no account .
square	He bought a plate with four corners so he could have a square meal .
peeped	' ' I didn ' t look at all ! ' ' Tom peeped .
Melody	My name is Melody . A Musician
ties	Two companies that made shoelaces had common ties .
gas	Why was the car embarrassed ? Because it had gas !
NP	I was arrested after my therapist suggested I take something for my kleptomania .
NP	Doctor , Doctor , my hair is coming out . What can you give me to keep it in ? - A cigar box . Next .
arrangements	OLD FLORISTS never die , they just make alternative arrangements .
alive	When entering a funeral home , remember to stay alert and always look alive !
stuff	Taxidermists really know their stuff .
jam	Two blackberries met . They were both in a jam .
stitches	Two surgeons were joking about sutures and had each other in stitches .
accident	My boyfriend and I started to date after he backed his car into mine . We met by accident .
windows	Some burglars are always looking for windows of opportunity .
plane	OLD PILOTS never die they just go to a higher plane .
pressed	Dry cleaners are often pressed for time .
work	Cousteau was submerged in his work .
stock	I went to the store to buy some soup but they were out of stock .
stripes	Sports are refereed by people of many stripes .
sucked	My new expensive vacuum cleaner really sucked .
speech	A restaurant owner gave his cooks a stirring speech .
stated	I travel all over America , Tom stated .
spark	OLD PYROMANIACS never die , they just lose their spark
dead	The Easter story is not a dead issue .
false	Be true to your teeth , or they will be false to you .
mark	Don’t let your footprints in the sands of time be the mark of a heel
pony	Five brothers wanted to buy a horse , so they all had to pony up .
sleep	He couldn ' t decide whether to accept a job in mattress sales so he decided to sleep on it .
prune	When the plums dry on your tree , it ' s time to prune .
terminal	If you get sick at the airport it could be a terminal illness .
Gap	The dentist ' s favourite shopping centre was ' The Gap ' .
cook	Before he was hired as a short order cook they grilled him .
holidays	Business at the candle factory tapered off after the holidays .
rough	The golfer guessed that his ball landed 20 feet off the fairway . Of course , that was just a rough estimate .
tips	Pencil sharpeners have a tough life - they live off tips .
settle	Two referees went head to head because they had a score to settle .
funny	A circus lion won ' t eat clowns because they taste funny .
taken	In an office : Would the person who took the step ladder yesterday kindly bring it back or further steps will be taken .
drive	OLD GOLFERS never die , they just lose their drive .
gravy	When it was lumpy he had a beef with his gravy .
house	A pop singer bought a new house for a song .
marriage	Two florists got married . It was an arranged marriage .
tangent	OLD GEOMETRY TEACHERS never die , they just go off on a tangent .
grainy	The photograph that I took of the sandstorm turned out grainy .
staff	The owner of the hair salon had to make cuts on his staff .
date	One palm tree said to another ' let ' s have a date . '
bed	It ' s a fact , taller people sleep longer in bed .
bang	Nobel got a big bang out of it .
blowing	Those working in tissue research and testing are always blowing it .
work	For the office drunk : He generally found him loaded with work to do .
Make	Doctor , Doctor , what would you take for this cold ? - Make me an offer . Next .
let	An undertaker can be one of your best friends , he is always the last one to let you down .
month	Labor Day is a good time to stop and reflect on the august events the the preceding month .
draw	Two pencils decided to have a race . The outcome was a draw .
tailor	' ' Waiter , there ' s a fly in my soup ! ' ' ' ' Force of habit , sir , the chef used to be a tailor .
starts	You know what happens after you miss math class ? It starts adding up .
stinks	I crossed a cell phone with a skunk , and now the service stinks .
rocky	I hear the Sylvester Stallone Film Festival got off to a rocky start .
fly	I wanted to bring a penguin home but my parents said that wasn ' t going to fly .
mint	He collects mouthwash bottles , and they ' re all in mint condition .
element	Early nuclear experimenters discovered an element of surprise .
pass	After Junior swallowed the watch he had to wait to pass the time .
exhausted	OLD AUTO MECHANICS never die , they just become exhausted .
rulers	Two companies that manufactured rulers decided to align .
food	Waiter , there are pennies in my soup ! ' ' Well , sir , you said you ' d stop eating here if there wasn ' t some change in the food . ' ' *
contain	I tried to pack myself in a suitcase . I could hardly contain myself .
Leo	My name is Leo . A lion trainer .
toothpaste	The river crested when a factory spilled toothpaste into it .
quarter	When video arcades switched to a system of tokens , there was no quarter asked or given .
downhill	The Alpine Skiing competition started poorly and went downhill from there .
cheap	A gardening store owner who often called long distance for importing realized that talk and dirt aren ' t necessarily cheap .
missing	If you wear a blindfold at the shooting range , you won ' t know what you ' re missing .
deliverer	When a letter carrier became a hero they called him a deliverer .
knitting	' ' I ' ve run out of wool , ' ' said Tom , knitting his brow .
book	Librarians are always going by the book .
pan	The prospector didn ' t think his career would pan out .
pointless	To write with a broken pencil is pointless .
slipping	The ice at the rink has many ruts . I think the maintenance crew is slipping up .
landslide	There was a contest on a slippery rock slope . I won in a landslide .
later	Doctor , doctor , I keep thinking I ' m a deck of cards . - I ' ll deal with you later . Next !
turn	OLD FARMERS never die , they just turn into vegetables .
clerical	When a priest makes a mistake in church it ' s a clerical error .
hanging	In the old days a suspended sentence was hanging .
wing	The first time I got hold of a hang glider I had to wing it .
couple	The coffee tasted like mud because it was ground a couple of minutes ago .
faculties	OLD DEANS never die they just lose their faculties .
bun	Show me a baker who is on a roll and I ' ll show you someone sitting on a bun .
potential	OLD ELECTRICIANS never die , they just lose their potential .
cant’s	Success comes in cans , failure comes in cant’s
crack	She was only a Junkie ' s daughter but her crack was the best in town .
snapped	I know road rage is an awful thing but when someone bumped my car I just couldn ' t help it . I got out my camera and snapped at the offender .
together	She was only a Cattleman ' s daughter , but she couldn ' t keep her calves together .
flag	I tried hard to get into vexillology , but , in the end , had to flag it away .
ruins	An archaeologist ' s career ended in ruins .
cabinets	OLD PRESIDENTS never die , they just go through their cabinets
crowed	I ' ve spotted more blackbirds than you have , Tom crowed .
justification	OLD TYPISTS never die , they just lose their justification .
replied	I ' ll glue the sheets of wood back together , Tom replied .
pine	Old lumberjacks never die , they just pine away .
ironed	Early stone tools had many problems that were eventually ironed out .
riveting	He was facinated by his new welding job . It was riveting .
span	Bridge tolls have increased significantly over a 5 year span .
work	Those who polish cars so that they shine work in a buffer zone .
bunch	Did you see guys that Bob the ventriloquist hangs out with ? They ' re nothing special , just a bunch of dummies .
attention	We were so poor when I was growing up we couldn ' t even afford to pay attention .
change	When you give to god , you always get back change
steep	I was going to buy some loose tea , but the price was too steep .
fortified	The sergeant drank whiskey in order to be fortified in his position .
expire	OLD COUPON CLIPPERS never die , they just expire .
connections	She was only a Electrician ' s daughter , but she certainly had good connections .
relative	The harm caused by sibling rivalry is relative .
dream	When the woman got paid for being in a study at the sleep clinic , she said it was her dream job .
bored	A carpenter sat on his drill and was bored to tears .
multi	A library should have several floors because it is a multi story building .
wave	We don’t read palms ; we wave them .
hash	Two cooks disagreed but decided to hash it over .
hold	The tongue weighs very little , but few people can hold it .
credit	She ' s a composer who has scores of works to her credit .
impression	When he fell in the wet concrete he left a bad impression .
Herb	My name is Herb . I ' m a cook .
triggered	There was a report of shots fired in a local bar . The police don ' t know what triggered the commotion .
staple	A goat that ate office supplies was on a staple diet .
proof	When the wino suspected his muscatel was watered down , he needed more proof .
count	The bargain store promised a free abacus with every purchase , but I wouldn ' t count on it .
tricky	Illusionists always find themselves in tricky situations .
juicy	The orange squeezer was invented with some juicy information .
lousy	OLD NITPICKERS never die , they just feel lousy .
going	Comedians , the biggest joke going .
nuts	Why didn ' t the little boy ask the flight attendant for a snack ? He didn ' t have the nuts .
planted	Why did the agricultural presentation go so smoothly ? They planted questions .
back	I couldn ' t quite remember how to throw a boomerang , but eventually it came back to me .
trace	OLD FORGERS never die , they just leave no trace .
charge	When buying a battery you should never have to charge it .
grip	OLD WRESTLERS never die they just lose their grip .
filed	In the office she was frantically looking for her false nails only to discover she had filed them away .
class	OLD TEACHERS never die they just lose their class .
flash	Gunpowder was invented in a flash .
blended	The frog went unnoticed in the milkshake because it blended so well .
refuse	Sign in an electrician ' s shop : ' We will refuse you . '
grain	Low carb diets really go against the grain .
combing	A wig van blew up on the motorway - police are combing the area .
Sandy	My name is Sandy . I ' m a lifeguard .
bungee	He had a difficult time bouncing back from his bungee cord accident .
squealer	A tattle tale pig is a squealer .
cycles	Bike sales go in cycles .
serving	A waiter who played tennis was great at serving .
late	An old professor who was never on time died and was called the late professor Brown .
heat	Two cooks had a contest and the heat was on .
clubs	When cave men got together they formed clubs .
signs	My friend was fired from his job at the road department for stealing . I have to say I saw it coming . The last time I was at his house all the signs were there .
downhill	My skiing skills are really going downhill .
Sit	Doctor , doctor , I keep thinking I ' m a spoon . - Sit there and don ' t stir . Next .
pitched	Baseball is known for its pitched battles .
mammoth	Reassembling the skeletons of prehistoric mammals can be a mammoth undertaking .
problems	Math teachers have lots of problems .
dig	Graveyard workers really dig their jobs .
clothes	I ' m blind enough to look at the situation in the wrong fashion , so I changed my clothes .
spruced	Before he sold Christmas trees , he got himself spruced up .
kick	OLD SOCCER PLAYERS never die , they just lose their kick .
slice	Golfers hate cake because they might get a slice .
say	Her decision to take up rock climbing was precipitous to say the least .
Ray	My name is Ray . I ' m a roentgenologist .
winter	If pride goes before a fall , humility should arrive by that winter
bottled	The psychiatrist told the genie his emotions were all bottled up .
square	After they had it out in the boxing ring , they called it square .
god	He who lends to the poor gets interest from god
electric	Power corrupts , especially at the electric company .
shrink	OLD PSYCHIATRISTS never die , they just shrink away .
support	A politician with a bad back needs lots of support .
plate	She had two different jobs as a chef which gave her a full plate .
disappear	OLD MAGICIANS never die they just disappear .
connections	Conjoined twins aren ' t the only twins with special connections .
charged	The two guys caught drinking battery acid will soon be charged .
boot	OLD SHOEMAKERS never die , they are just given the boot .
flash	The exhibitionist went to the store because he heard they were having a flash sale .
bases	A baseball player joined the army and did the round of military bases .
use	If word processing a presentation about guns - - be sure to know how to use bullets .
weather	OLD METEOROLOGISTS never die , they just get under the weather .
buffaloed	A case of disappearing bison had police completely buffaloed .
lie	Any golfer will tell you the gospel truth . Your next shot always depends on the lie .
clients	A tatoo artist has designs on his clients .
drills	Dentists practice by going through many drills .
steal	OLD PICKPOCKETS never die , they just steal away .
pop	A little boy called his father who made balloons ' pop ' .
flop	The stock market crashes , but Viagra beats the flop .
forefinger	Three fingers were willing to cooperate but the thumb and forefinger were opposed .
inclined	Those who build roofs are so inclined .
downhill	A skier who makes it to the olympics finds that it is all downhill from there .
right	When the human cannonball retired they couldn ' t find a replacement of the right caliber .
stable	A horse is a very stable animal .
cold	OLD ESKIMOS never die , they just go cold .
habit	You really are addicted to soccer , you should think of kicking the habit .
bench	She was only a Magistrates daughter , but she knew what to do on the bench .
grouper	The first fish to gather in schools was the grouper .
get	I wanted to lose weight so I went to the paint store . I heard I could get thinner there .
floods	If all your troubles are melting away watch out for the floods .
steal	OLD PLAGIARISTS never die , they just steal away .
clean	I used to be addicted to soap , but I ' m clean now .
heartless	Some cardiologists are heartless .
steep	I went to buy some property with a hill on it , but it was a little steep .
well	I find that movies about submarines always go down well .
drive	A racer who was also a golfer really knew how to drive .
party	If you invite an insomniac to your pajama party they will be up for it .
drill	Army dentists make a good drill corps .
rash	Dermatologists often make rash statements .
Bet	My name is Bet . I ' m a coupier .
swell	A young sailor thought all of the waves were just swell .
bits	OLD PROGRAMMERS never die they just go to bits .
sewer	Backups are usually a good thing unless it ' s a sewer .
storm	The Vikings landed during thunder and lightning and took the city by storm .
dough	OLD BREAD MEN never die , they just lose their dough .
scale	Seafood operations start out on a small scale .
grants	Civil servants named Grant are known as government grants .
degree	I might study something at a university that someone once told me about - there is a degree of ambiguity there .
finished	When ancient wall sculptors were finished it was a relief .
frank	The hot dog vendor answered , with a tone quite frank .
expressions	OLD MATH PROFESSORS never die , they just use strange expressions .
waste	OLD SEWAGE WORKERS never die they just waste away .
carry	The thief had a bold plan . He figured he could carry it off .
vision	OLD SEERS never die they just lose their vision .
present	Everyday is a gift from god , that is why it is called the present
high	There’s no high like the most high .
decreased	OLD LAUNDRY WORKERS never die , they just are decreased .
still	She was only a Moonshiner ' s daughter , but I love her still .
faculties	OLD UNIVERSITY PRESIDENTS never die , they just lose their faculties
afraid	I was going to buy a book on phobias , but I was afraid it wouldn ' t help me .
foiled	The aluminum foiled my plans .
dish	She was only a Waitress ' s daughter but she sure could dish it out .
suggestions	The hypnotist went out of business because he ran out of suggestions .
flexible	For class schedules Yoga instructors are flexible .
getting	Hockey players are terrible chess players because they are always getting checked .
work	I do a lot of spreadsheets in the office so you can say I ' m excelling at work .
strained	He bent over to pick up a sieve and strained himself .
well	When they told him that his drum couldn ' t be fixed , it didn ' t resonate very well .
hooks	A fisherman tried boxing , but he only threw hooks .
sweet	Winning candy as a prize is always a sweet victory .
noted	During his lifetime , the composer Bach was a noted success .
discarded	OLD POKER PLAYERS never die , they are just discarded .
snapped	' ' I can take photographs if I want to ! ' ' Tom snapped .
NP	Lightning storms can be very striking .
tops	Our bikinis are exciting . They are simply the tops .
girl	High on a ladder he saw a beautiful girl below . He fell for her .
brewing	When underwear fell in the vat at a beer - makers , a scandal was brewing .
point	Pencils could be made with erasers at both ends , but what would be the point ?
steal	Old burglars never die they just steal away .
logs	Lumberjacks have to keep problem logs .
Grant	My name is Grant , I am a loan officer .
breeches	Midwives don ' t like to wear breeches .
fertilize	She was only a Farmer ' s daughter , but she knew hundreds of ways to fertilize .
degree	Molecules boiling points vary to some degree .
Joe	My name is Joe , an espresso vender
skip	Two friends took ropes to school so that they could skip out .
happy	Many people need to learn to be happy with the State they are in .
pressure	Pipe fitters often have high pressure jobs .
nagged	' ' I told you not to ride that horse , ' ' Tom nagged .
mind	Coaches usually have a goal in mind .
ride	The meat truck took a long time to deliver because of the Jerky ride .
overboard	Suicide at sea is definitely going overboard .
got	An exterminator in Idaho announced that he invented a new spray , one application of which will remain effective for a full season . ' ' Of course , ' ' he warned . ' ' I ' ve still got a few bugs to iron out . ' '
trouble	Swimmers have to be careful not to get into deep trouble .
derail	OLD RAILROADERS never die , they just derail .
snap	The invention of a shirt fastener after the button was a snap .
NP	Life after death for evil doers has always been a hot topic .
rash	The man who impulsively got a cat despite his allergies later realized that it was a rash decision .
fold	OLD CARD PLAYERS never die , they just fold .
melons	She was only a Fruit vendor ' s daughter , but , my , she had big melons .
pressure	Boyle said he was under too much pressure .
rose	The color of the sun in the early morning : rose .
toll	Driving on so many turnpikes was taking its toll .
cured	A ham walked out of the hospital and said ' ' I ' m cured ' ' .
search	If you ' re looking for oranges on an apple tree you will have a fruitless search .
hard	In high school I recall having a beautiful but difficult math teacher . She was easy on the eyes and hard on the pupils !
cutting	Those with scissors shouldn ' t use cutting words .
NP	What ' s the deal with negotiations ?
relative	The family elders have relative importance .
frosty	A skier who loses a race on a cold day will have a frosty disposition .
bugged	OLD PROGRAMMERS never die , they just get bugged with life .
others	Christians , keep the faith . . . but not from others !
dawn	Those who get up at sunrise have many ideas dawn on them .
tips	An experienced waiter can give a lot of good tips .
worked	' ' This must be an aerobics class , ' ' Tom worked out .
hip	The most popular operation for orthopaedic surgeons is upper - leg surgery : very hip .
stages	Actors are cast through their good and bad stages .
pound	Food for bad dogs is bought by the pound .
house	My son wanted a scooter . When I told him they are too dangerous , he moped around the house .
tangent	OLD MATHEMATICIANS never die , they just go off on a tangent
hardened	A thief fell and broke his leg in wet cement . He became a hardened criminal .
NP	De Broglie waved aside the invitation .
start	In parking lots , arguments often start from scratch .
boot	Some shoe sales have a good selection to boot .
people	When the town removed billboards , they told people that ' s how it was designed .
shoot	An army officer is a position that some people shoot for .
store	The electrician got his supplies at the outlet store .
deadwood	The lumber company downsized . They got rid of the deadwood .
buzz	Waiter , there ' s a fly in my soup ! ' ' I know . It gives you a nice buzz doesn ' t it ? ' '
threads	Tailors enjoy hanging out in internet fora , as they are full of threads .
approval	Priests can ' t marry without prior approval .
perspective	Old artists never die , they just put things in perspective .
rattled	Go away , you snake ! Tom rattled off .
underhanded	I never understood why people liked to play soft ball . It ' s a very underhanded thing to do .
bed	Tom was so tired , he lied about his bed .
draw	She was only an Artist ' s daughter , but what a crowd she could draw .
chicken	OLD KENTUCKY FRIED CHICKEN FRANCHISERS never die , they just chicken out .
die	OLD PILOTS never die they just take off .
Marshall	My name is Marshall . I ' m a peace officier .
viewpoints	Astronomers often have their own private viewpoints .
bowled	OLD CRICKETERS never die , they just get bowled over .
crane	Smaller babies may be delivered by stork but the heavier ones need a crane .
problem	A farmer with a rip in his clothes has an overall problem .
calf	She was only a Dairyman ' s daughter , but what a calf
Next	Doctor , Doctor , this ointment you gave me makes my arm smart . . - Then rub some on your head ? Next .
pin	It ' s quiet in a bowling alley because you can hear a pin drop .
average	I just got back from a statistical probability conference . It was average .
trip	OLD HIPPIES never die , they just take a trip .
shoulders	I finally found a spotter at the gym , it ' s like a huge weight has been lifted off my shoulders .
meetings	Shepherds sometimes have staff meetings .
NP	After having a knee dislocated and an elbow fractured in two barroom brawls Bradley should have learned to stay away from those joints .
cool	OLD AIR CONDITIONER REPAIRMEN never die , they just lose their cool .
connections	To be a successful frequent flier you need a lot of connections .
log	What do they call all that lumber on the Star Trek ' s Enterprise ? Captain ' s log .
nothing	After Gus gave his girlfriend a 3 dollar box of chocolates for her birthday he got nothing but snickers .
clammed	Did you hear about the bivalve they called in to interrogate for that big murder investigation ? Apparently , he ' s clammed up .
time	At a conference , I unexpectedly encountered the wife of a former client , whom I hadn ' t seen in 20 or more years . ' ' You haven ' t changed ! ' ' she exclaimed . ' ' There ' s plenty of time for that , ' ' I replied . ' ' The dinner isn ' t until this evening . ' '
wrenching	Changing a tire on that crazy Houston freeway was a wrenching experience .
rivals	Two podiatrists became arch rivals .
blew	A husband and wife argued over the weather , but it soon blew over .
cutting	I needed a raise in my allowance . Mowing the grass all summer just wasn ' t cutting it .
year	I think Santa has riverfront property in Brazil . All our presents came from Amazon this year .
unattended	Husbands are like fires . They go out when unattended .
light	A manufacturer that made lamps gave their employees a light workload .
dry	If towels could tell jokes they would probably have a dry sense of humor .
power	An office with many people and few electrical outlets could be in for a power struggle .
groovy	Vinyl records are really groovy .
plunge	Before a plumber retired , he took the final plunge .
Jesus	Firefighters can rescue you , but only Jesus saves .
idea	Faraday was charged up with the idea .
appendix	An unusual medical book is one which has no appendix .
new	A tire store loves a chance to Roll out a new product .
Fret	If you break a string on your guitar don ' t Fret .
marked	After he bought his two - year - old a felt pen , he was a marked man .
draw	OLD CARTOONISTS never die , they just draw their last breath .
pruned	The plums for sale dried out , so the profits were pruned .
happy	When a duck is feeling down he might just be happy .
date	This is the best guy I ' ve met to date .
potato	Waiter , I ' ll have my bill now . - How did you find your steak , sir ? - Oh , I just moved the potato and there it was .
peanuts	Elephants will toil all day , and they work for peanuts .
figures	OLD AUDITORS never die , they just lose their figures .
turn	The other day I saw a magician walk down the street and turn into a drugstore .
race	The racers all had shorts on that were too small for them , so it was a tight race .
bars	She was only a Convict ' s daughter , but she sure knew all of the bars .
cuckoo	Some clockmakers are normal , but others are a little cuckoo .
crowns	They called him the king of the dentists because he specialized in crowns .
clean	A man stole a case of soap from the corner store . The police said he made a clean getaway .
leaked	News of a coming flood was leaked .
calling	She became a telephone operator because it was her calling .
favors	The politician is not one for Indian food . But he ' s good at currying favors .
staying	If you are what you eat , I ' m staying away from the nuts !
Clay	My name is Clay . I make pottery .
right	One of these new shoes isn ' t right .
drop	Doctor , Doctor , I can ' t get to sleep . - Sit on the edge of the bed and you ' ll soon drop off . Next .
plate	I went to the dentist without lunch , and he gave me a plate .
swept	OLD JANITORS never die they just get swept up .
touch	The massage which came with the spa treatment was a nice touch .
die	OLD SHOE SHINE BOYS never die , they are just rebuffed . .
run	Here is how the track meet is going to run . . .
parking	How do I handle change ? I put it in the parking meter .
beneath	I ' ve never taken an elevator to the basement floor , that ' s just beneath me .
shot	I ' ve never killed a deer before but I ' ll take a shot at it .
Digital	Hands in Prayer : Already Digital
sweet	Diabetics should not be allowed to have sweet dreams .
pay	I ' m going to the guillotine at dawn and my wife has already collected my severance pay .
adjustment	After 5 years with the same chiropractor , I moved and had to change doctors . It was quite an adjustment .
layoffs	We ' re expecting fallout from the recent layoffs at the nuclear plant .
solution	A scientist doing a large experiment with liquid chemicals was trying to solve a problem when he fell in and became part of the solution .
days	I got a great bargain the other day when I bought a forklift for half - price . It ' s amazing what you can pick up these days .
entranced	' ' I just came in through the door , ' ' said Tom , entranced .
got	Dutch shoes used to be made in a factory machine , until it got clogged up .
bundle	The inventor of a hay baling machine made a bundle .
sit	Even if you ' re on the right track , you ' ll get run over if you just sit there .
spent	When the investor came home from work he was spent .
plugging	Old electricians never die , they just keep plugging away .
uprooted	OLD GARDENERS never die , they just get uprooted .
chemistry	The science teachers broke up because there was no chemistry between them .
tracks	How do you find a missing train ? Follow the tracks .
Brandy	My name is Brandy . The bartender .
Ham	My name is Ham . I raise pigs
first	Ohm resisted the idea at first .
working	The personal trainer quit his job because it wasn ' t working out .
blackboard	The math professor went crazy with the blackboard . He did a number on it .
dukes	Madame : ' ' Now remember , girls , when handling royalty the important thing is to keep up your dukes ! ' '
tired	Do you ever get tired of sleeping ?
breakfast	I was in a big hurry so I scrambled to make eggs for breakfast .
behind	I had some back trouble , but it ' s all behind me now .
one	Just after thimbles were invented there was a shortage , so many people got stuck without one .
birds	Badminton players are for the birds .
baloney	The untruthful deli clerk was full of baloney .
glowing	When neon lights were perfected the inventor was positively glowing .
Sue	My name is Sue . I ' m also a lawyer .
business	The manufacturers of dynamite do a booming business .
feet	Gardeners like to plant their feet firmly .
ear	One grasshopper told another about eating corn . It went in one ear and out the other .
shoots	Did you hear about the guy who planted bullets ? He wanted to see a lot of little shoots .
drone	Pompous male bees are often known to drone on about themselves .
wages	The parsley farmer couldn ' t pay his child support , so the courts garnished his wages .
purpose	She started a new courier business for an express purpose .
pale	She always paints night scenes . Other artists pale by comparison .
rare	Some people like raw meat on rare occasions .
religious	To a person who is attentive to minutiae : ' ' You ' re certainly observant , even if you ' re not religious . ' '
grounded	An Electrician ' s work is well grounded .
fired	When he found out that he would visit a real blacksmith he got all fired up .
dry	The scorpion said to the desert , ' You know , our conversations are always so dry . '
blowup	An argument at the Bomb Squad convention ended in a blowup .
pooped	After a day of changing her triplet ' s diapers , the new mother was feeling rather pooped .
magazine	You ' ve got more issues than Time magazine .
cuts	Saw makers losing money have to make lots of cuts .
docked	When longshoremen show up late for work they get docked .
repossessed	OLD EXORCISTS never die , they just get repossessed .
truck	Doctor , doctor , I think I ' m a bridge . - What ' s come over you ? - Two cars , a truck and a coach .
haywire	She was only a Electrician ' s daughter , but she went haywire .
spirits	OLD MEDIUMS never die , they just lose their spirits .
complex	I used to be afraid of purchasing residential property for the purpose of renting , but now I have an apartment complex .
split	OLD LUMBERJACKS never die , they just split .
everyone	Martians welcome . We have space for everyone .
balls	It ' s not that the man did not know how to juggle , he just didn ' t have the balls to do it .
change	A small boy swallowed some coins and was taken to a hospital . When his grandmother telephoned to ask how he was a nurse said ' No change yet ' .
stroke	OLD SWIMMERS never die , they just have a stroke .
leaf	The landscaper thought gardening magazines were fun to leaf through .
stacked	She was only a Bricklayer ' s daughter , but she was certainly stacked .
driving	A boy saving up for a car has a lot of driving ambition .
Dean	My name is Dean A college chancellor
Knock	When I commented on a friend ' s psychedelic door he said , Don ' t Knock It .
line	The fish missed the call because he was stuck on the other line .
meet	OLD CONTORTIONISTS never die , they just meet their end .
faith	No bungee cords , but we encourage leaps of faith .
minutes	My friend came around for dinner . We ate for 20 minutes , then he fainted again .
toast	My friend ' s bakery burned down last night . Now his business is toast .
perfectly	I can do an excellent impression of Sinatra , said Tom , being perfectly frank .
spin	The roulette dealer had a unique personality . He had a different spin on everything .
radio	He was able to listen to his favorite radio show in the morning because he had an AM radio
operate	She was only a Doctor ' s daughter , but she really knew how to operate .
conduct	Musicians need a leader because they don ' t know how to conduct themselves .
canvas	After the six campers were discovered missing from their tents the state police began to canvas the area .
exercise	Jumping to conclusions is bad exercise
cooked	An accountant for a restaurant has to be sure the books are not cooked .
exhausted	OLD MUFFLERS never die they just get exhausted .
NP	If you’re looking for a sign from god , this is it .
trail	OLD HIKERS never die , they just trail away .
eyes	People who make necklaces may get beady eyes .
downhill	A skier retired because he was going downhill .
Next	Doctor , Doctor I feel like a pair of curtains - Well pull yourself together then . Next .
stand	The gravity was so powerful , I couldn ' t stand it .
Pat	My name is Pat . I am a masseur
memory	I can ' t remember ever getting nits as a kid , although I do have a lousy memory .
stunning	I knew a woman who owned a taser , man was she stunning !
gel	The thought of having no alternative to soap never washed with the inventor of shower gel .
back	Did you hear about the man who was jabbed in the back with a set of keys ? His back locked up .
sign	OLD INTERPRETERS (for the deaf) never die , they just sign off .
calf	The dairy farmer while milking his cow strained his calf in the process .
table	He was a janitor in the restaurant . He did things under the table .
projecting	If you think guests really enjoy your home movies , you are probably projecting .
plant	Just because pews come in rows doesn’t mean we should plant ourselves there
grandfathering	My father ' s father wanted to know if he could stay with the company in spite of the many changes . They ended up grandfathering him in .
poacher	Getting this job managing a country estate has put me off fried eggs . I ' m a gamekeeper turned poacher .
reservations	I wanted to have dinner at a native American themed restaurant , but I didn ' t have reservations .
stave	Why did the termites eat the wooden barrel ? To stave off hunger .
together	She was only a Rancher ' s daughter , but she couldn ' t keep her calves together .
thrown	The intelligent entrepreneur ' s idea for designing catapults meant that his boss was completely thrown .
kidding	A boy told his parents he wanted to raise goats for a living , but he was only kidding .
sharp	A guy went to a costume party dressed as a knife , and he really looked sharp .
point	OLD SEAMSTRESSES never die , they just come to the point .
stalking	Thieves who steal corn from a garden could be charged with stalking .
faculties	Old school principals never die , they just lose their faculties .
looking	A hole has been found in the nudist camp wall . The police are looking into it .
knockout	The boxer ' s girlfriend was a knockout .
hook	A pirate with one hand often picked up the phone . He wanted to get off the hook .
reflective	After he bought a mirror he became very reflective .
impact	A dentist with a toothache could have a bad impact on his patients .
abilities	Plumbers often have to tap their natural abilities .
DRIFT	He threw snow in his neighbor ' s driveway and shouted , DO YOU GET MY DRIFT ?
strain	Old colanders never die , they just can ' t take the strain anymore .
sentence	A prisoner ' s favorite punctuation mark is the period . It marks the end of his sentence .
picket	The fence builders were upset with their working conditions , so the started to picket .
sleeves	If your waiting for something to turn up , try your sleeves .
kill	He stomped on his old watch because he had time to kill .
absorbed	Those who make sponges get very absorbed in their work .
gutter	OLD BOWLERS never die they just end up in the gutter .
NP	Hell’s the pits
connections	OLD ELECTRICIANS never die , they just can ' t make connections
useless	When the butter melted , it was rendered useless .
baggage	The airlines have become so cash - strapped , they charged me for my emotional baggage .
exam	The cosmetic student was sick on the day of the final exam . Now she has to take a Make Up exam .
Liquid	Q : River Ravi flows in which state ? A : Liquid .
circulation	OLD NEWSPAPER PUBLISHERS never die , they just lose their circulation .
stern	A leak in the back of a boat is a stern warning .
day	A politician decided to resign on the day of an eclipse because it was a dark day .
buzz	When the beekeeper moved into town he created quite a buzz .
projected	' ' This movie will be very popular , ' ' Tom projected .
cop	OLD POLICEMEN never die they just cop out .
fired	OLD HUMAN CANNONBALLS never die they just get fired .
developing	OLD PHOTOGRAPHERS never die they just stop developing .
experience	Edison thought it would be an illuminating experience .
counter	The best place for a mathematician is behind a counter .
struck	I was struggling to figure out how lightning works then it struck me .
net	The man found something to catch fish , which was a net gain .
cover	She was only a Librarian ' s daughter , but she was checked out from cover to cover .
bouncing	Basketball players are always bouncing ideas off each other .
full	Some business graphs are full of legend .
Nothing	Tennis players don ' t marry because Love means Nothing to them .
resigned	John Hancock didn ' t retire , he just resigned .
crop	I ' ve planted part of a riding whip . I ' m hoping for a nice crop .
NP	' Coming ready or not ! ’ – Jesus .
lawn	The seed company turfed out my idea for ready made lawn .
road	I hate it when motorcyclists hog the road .
know	An old lady once asked the dispatcher of a local trucking company if they could ship an antique mirror to her sister in Toronto . The dispatcher says , ' I don ' t know madam , I ' d have to look into it first ' .
pine	OLD TREE SURGEONS never die , they just pine away .
perfect	My mailman should be a comedian , his delivery is perfect !
sentence	If a judge loves the sound of his own voice , expect a long sentence .
spectacles	Two monocles were making love in front of a window and made spectacles of themselves .
withdrawal	Whenever I go near my bank I get withdrawal symptoms .
taking	For a chronically absent employee : It seemed her career was just taking off .
stock	A rock band set up on the exchange floor . They wanted to play the stock market .
breaking	Back when the news was written on clay tablets there was a lot of breaking news .
first	When there ' s a sale on tennis balls it ' s first come first serve .
disaster	My job as head chef at a top rated restaurant is in jeopardy because my latest culinary creation was called a recipe for disaster .
double	She was always calling for her twins , ' ' on the double . ' '
standards	She was only a Flag - waver ' s daughter , but she ' d let her standards down for anyone .
hardened	When the thief fell in the wet cement and broke both legs , he became a hardened criminal .
sufficient	I was fired from my job selling amplifiers . I didn ' t achieve the sufficient volume of sales .
hooked	Did you hear about the compulsive fisherman ? He was really hooked on it .
Stops	Sign at a deer crossing : The Buck Stops Here .
occasion	The unveiling of the statue was a monumental occasion .
going	You won ' t often catch loggers or farmers going against the grain .
Charity	My name is Charity , a televangelist
shell	It ' s hard for a depressed turtle to get out of his shell .
problem	An apple farmer with poor yields has to get to the core of the problem .
looking	As soon as the airplane was invented , things were looking up .
space	An astronomy column in the newspaper would have a lot of space devoted to it .
flying	When the plane hit turbulence , the passengers went flying .
everyone	Gravity , it ' s always putting everyone down .
Mark	My name is Mark . I price items at the supermarket .
rage	Did you hear about that new drug that makes people angry ? It ' s all the rage now .
credit	Honor your mother and father rather than major credit cards .
heart	She memorized just what kind of locket she wanted , by heart .
went	He was a Red Cross donor until he went out of circulation .
snags	She wanted to be a weaver but there were always too many snags .
bloomers	Eve showed up one morning wearing flowers instead of a fig leaf . She was the first woman to wear bloomers .
moles	The dermatologist was an avid gardener but he had a problem with moles .
walked	A dog who played baseball always got walked .
experience	Making gloves is a real hands - on experience .
said	If you breathe heavily on the map , it will reveal topography , ' he said , with a sigh of relief .
season	Alergy sufferers are itching to get through the hay fever season .
retire	OLD AUTO MECHANICS never die , they just retire .
improving	I still miss my ex - husband . But my aim is improving .
retired	OLD WHEELS never die they just get retired .
plumb	The building inspector said whoever installed the water pipes was plumb loco .
education	Geology class is the foundation of a decent education .
fill	She was only a Dentist ' s daughter , but everybody wanted to fill her cavity .
dead	Sin enough and you will become dead to it .
round	I walked past a gang of youths yesterday and one of them threw a piece of cheese at me , which hit me on the back of the head . I turned round and shouted , ' ' That ' s not very mature ! ' '
trooper	The state police highway officer worked tirelessly in the heavy rain to assist a lady whose car was stuck in a ditch . He was a real trooper .
hives	My coach got stung by a bee . The next day he had hives .
make	My friend asked me to carve a sculpture out of a large rock . It was the hardest thing I ' ve ever had to make !
balance	Old accountants never die , they just lose their balance .
calves	During branding cowboys have sore calves .
one	The math professor liked even numbers , but only the odd one .
killer	That new mystery novel has a killer start to it .
drill	I ' ve been to the dentist several times so I know the drill .
roots	A gardener who moved back to his home town rediscovered his roots .
research	Ampere was worried he wasn ' t up to current research .
stop	She was only a Bottlemaker ' s daughter , but nothing could stop her .
pool	Our country ' s olympic swimming program has quite a talent pool .
concentration	There was a guy who was fired from the orange juice factory for lack of concentration .
NP	She was only a Photographer ' s daughter , but she was really developed .
fault	Two geologists were staring at a huge fissure in a cliff face and one was overheard to say ' It ' s not my fault ' .
grounded	When the electrican apprentice made mistakes , his mother grounded him .
attend	VanDeGraaf charged his assistant to attend .
table	Harry and Clem the carpenters , argued mightily on how best to complete the dinette set they were working on . They finally agreed to table the discussion .
draw	His plan to manufacture pencils just didn ' t draw attention .
loan	One night a banking tycoon fell overboard from his yacht . He was saved because he could float a loan .
lost	My friends and I played a game of football on a pile of quarry rock - we lost on aggregate .
ring	A boxer who wants to get married has the ring to worry about .
NP	Inventors have their own devices .
evolved	Darwin said he ' d have to see what evolved .
reception	When the TV repairman got married the reception was excellent .
laid	OLD HOOKERS never die , they just get laid off .
elimination	Overheard in med school - ' I learned about the colon through the process of elimination . '
reservations	He recommended the restaurant to me , and said he had no reservations .
lumber	Old carpenters never die , they just lumber around .
retire	OLD GARAGEMEN never die , they just retire
pan	Tony attempted to join his thin crust pizza company with Zimo ' s Thick Crust Pizza , but somehow it didn ' t pan out .
fast	OLD SKIERS never die , but they go downhill fast .
ran	I majored in nursing but I had to drop it because I ran out of milk .
kidded	' ' My parents are called Billy and Nanny , ' ' Tom kidded .
stomach	I once knew a guy who had fish and chips every day for a year . His stomach took a battering .
thought	Pavlov was drooling at the thought .
strain	Continually discovering new viruses can become a strain .
knowledge	He studied water purification and had a great thirst for knowledge .
tuned	Those who play musical instruments for radio or TV have to stay tuned .
cafe	I met a girl at an internet cafe , but we didn ' t click .
beauty	A lovely lady who lost her watch became a timeless beauty .
scale	Prison walls are never built to scale .
bust	I was heading to Hooters but my wife said ' Don ' t bother , they have gone bust ' .
fit	A man tried working in a shoe store , but he just couldn ' t seem to fit in .
going	The calculus teacher tried to keep his students on task , but the class discussion kept going off on tangents .
boot	I got a deal on a new computer , and they threw in the operating system to boot .
recover	OLD UPHOLSTERERS never die , they just recover . .
hit	A new batter joined the baseball team , and he was a real hit .
Dick	My name is Dick . I ' m a plain - clothes policeman .
tax	On being served an extravagant dessert : ' ' So rich , it has its own tax shelters . ' '
town	She was only a Musician ' s daughter , but she knew all the bars in town .
entranced	What a charming doorway ! said Tom , entranced .
Rob	My name is Rob . I ' m a thief .
answer	A baseball pitcher asked if he had a good curve ball , but wanted a straight answer .
world	The astronauts said their experience on the moon was out of this world .
experience	A family went to watch a 007 movie at the theatre , it was a bonding experience .
real	After dating the goalie on the local team for a while , she realized he was a real keeper .
hold	Wrestlers don ' t like to be put on hold .
roll	OLD INVESTORS never die they just roll over .
future	Could modern submarines be the wave of the future ?
derailed	OLD TRAIN ENGINEERS never die , they just get derailed .
Sherry	My name is Sherry . I ' m a wine - master .
men	She was only an Archer ' s daughter , but to all the men she was the target .
question	The lawyer asked a loaded question about guns .
Holly	My name is Holly , I ' m a holiday decorator
swallow	He told me he could eat a 32 ounce steak , but I found that hard to swallow .
skills	The boy ' s guitar teacher helped him pick up his skills .
patch	Why was the rabbit depressed ? He was just going through a bad patch !
shelved	OLD GROCERS never die , they just get shelved .
minute	He was almost persuaded to invest in a poultry farm , but chickened out at the last minute .
people	The portrait artist made extra money as a census taker . He was good at canvasing people .
spin	It ' s true that the earth rotates , but scientists are always putting their own spin on it .
center	There was a sign on the lawn at a drug re - hab center that said ' Keep off the Grass ' .
took	His model airplane hobby really took off .
still	She was only a Bootleggers daughter , but I loved her still .
hitting	Have you ever wondered why baseball players get girlfriends ? They ' re great at hitting it off .
driving	He wanted desperately to be a good golfer - you could say he had a driving ambition .
run	If you walk along a railroad track you may soon feel run down .
aground	When the pirate captain ' s ship ran aground he couldn ' t fathom why .
please	Attention staff ! The clothes keep falling off the mannequins in ladies ' wear . Would someone please redress the problem ?
NP	Using deodorant is no sweat .
sum	A lawyer was defending a math teacher . He had to sum up .
bypass	Heart surgeons never bypass a good opportunity .
Victor	My name is Victor , and I ' m a winner in everything I do .
Faith	My name is Faith . I ' m a minister .
remains	The state funeral remains to be seen .
vegetate	Old gardeners never die they just vegetate .
refined	People who make motor oil are very refined .
envelope	If you send a letter to the Philippines put it in a Manila envelope .
cast	The play on fishing had quite a cast .
turn	Did you hear about these new reversible jackets ? I ' m excited to see how they turn out .
irons	It has been discovered that sales of irons are decreasing .
seconds	It ' s not the minutes spent at the table that put on weight , it ' s the seconds .
NP	When he proposed to her , she found it very engaging .
fell	When I asked the man how he became a ditch - digger , he said he just fell into it .
cinch	Anyone should know how to put a saddle on a horse so it won ' t slip and cause an injury . It ' s a cinch .
rocks	That ' s a cool chair . Yeah , I know , it rocks .
strain	If you run through a screen door you ' ll strain yourself .
buzz	There is rarely a sale on beer because the demand is always high so there ' s no need to create a buzz .
splitting	Did the reproducing amoeba get a splitting headache ?
swamped	Since I ' ve taken the job in The Everglades I ' ve been swamped !
giving	To teach someone how to build a compass you have to be good at giving directions .
worth	The farmer decided to get a cow , and milk the idea for all it was worth .
underworld	OLD GANGSTERS never die , they just go to the underworld . .
wrapped	He who hogs the sheets is usually very wrapped up in himself .
Classified	The newspaper doesn ' t put in Politics what is Classified .
god	If there is a hypocrite between you and the church , he is closer to god than you .
bed	Can I tell you a story about my bed ? I made it up .
channels	I was going to order a satellite dish but then I found out that I had to go through channels .
group	Galois wanted to assemble his own group .
NP	My fear of planes has taken off .
search	The dentist ' s alibi was full of holes , so the police performed a cavity search .
topic	I ' m going to be discussing global warming next week , it ' s quite a heated topic .
fire	An artist with the military kept drawing enemy fire .
unstrung	OLD VIOLINISTS never die , they just become unstrung .
cold	He was hit on the head during a hail storm and was knocked out cold .
jerk	The car stopped with a jerk , then the jerk got out .
die	OLD CARDIOLOGISTS never die , they are just repulsed . .
combination	The safe was invented by a cop and a robber . It was quite a combination .
slide	OLD TROMBONISTS never die , they just slide away . . .
rave	The dance club opened to rave reviews .
go	She was only a Elevator operator ' s daughter , and she loved to go down .
argument	We spent all day debating about housefires . It was quite a heated argument .
busted	OLD STATUES never die they just get busted .
highlight	Students who accent their textbooks with color markers add a real highlight to their day .
NP	Pasteur was boiling about not being invited .
sentences	OLD JUDGES never die , they just slur their sentences
impact	Have you heard the joke about the bomb ? It had no impact .
stuck	He got a job in a factory making needles , but soon got stuck .
commission	OLD SALESMEN never die , they just go out of commission .
interest	OLD BANKERS never die they just lose interest .
Josh	My name is Josh . I ' m a talk show host
cashier	The one thing that is constant is Change especially if you are a cashier .
NP	That really nice fellow works in a clothing factory sewing zippers on jeans . That is good . He wouldn ' t hurt a fly .
plan	To plan a graveyard you need a skeleton idea before a detailed plan .
rocking	While the music was playing the geology teacher was rocking around .
flop	Banning Viagra was a big flop .
keep	The warden gave the inmates acne medicine hoping it would keep them from breaking out .
give	Plenty of people give the lord credit . Few give him cash .
memory	I really do have a photographic memory - - I just haven ' t developed it yet .
Next	Doctor , Doctor , should I file my nails ? - No . Throw them away like everybody else . Next .
posted	He ' s a good letter carrier . He always keeps you posted .
judgment	OLD LAWYERS never die they just lose their judgment .
shake	After selling a shipment of salt the salesman said ' let ' s shake on that . '
criminal	Someone who robs shoe stores is an arch criminal .
guts	The doctor couldn ' t transfer the organs because he didn ' t have the guts to do it .
police	The valuable dog was still missing , believed stolen , however the police announced they have a lead .
check	OLD LIBRARIANS never die , they just check out .
Come	Wal - Mart Is Not the Only Saving Place . Come On In .
ring	An hobbituary to Tolkien appeared in each of the major newspapers , all had a familiar ring to them .
connection	The passenger couldn ' t find where his next flight was , but then he made the connection .
impressed	When the branding iron was invented cattle were very impressed .
reacting	OLD CHEMISTS never die , they just stop reacting .
can	Why do people preserve fruits and vegetables ? Because they ' can ' .
mark	He bought lots of pens before starting his new job . He wanted to make his mark .
real	In the room the curtains were drawn , but the rest of the furniture was real .
NP	Males who wonder why they should have a prostate exam usually get it in the end .
resort	They argued about their vacation and finally stayed at the last resort .
cramming	Eating too many snacks when studying for a test is called cramming .
expressing	OLD COURIERS never die , they just keep on expressing it !
connections	She was only a Telephone operator ' s daughter , but she sure had good connections .
Rusty	My name is Rusty . I undercoat cars .
lied	' ' It ' s a German song , ' ' Tom lied .
lot	A teacher used his index finger to ask a lot of pointed questions .
longer	Since Bruce got too close to the big blade at the saw mill he is no longer feeling chipper .
undertaking	Opening a new funeral parlor can be quite an undertaking .
job	The oil well driller had a boring job .
faces	The man who worked at the watch factory was very funny . He stood about all day making faces .
item	Grills are a hot item .
pupils	There was once a cross - eyed teacher who couldn ' t control his pupils .
axes	A woodcutter ' s world revolves on his axes .
running	He has been a jogger for three years running .
respond	Occasionally , I hear an assertion followed by a hasty qualification , such as , ' ' Jim graduated in 1995 - - if memory serves . ' ' I ' ll respond : ' . . . or only stands and waits . ' '
touchy	In certain sexual harassment cases things can get kind of touchy .
dribbling	OLD BASKETBALL PLAYERS never die they just go on dribbling .
mechanically	I ' ve got to fix the automobile , said Tom mechanically .
May	Is there a best month of spring ? There May be .
stir	A guy swallowed a spoon and found he couldn ' t stir .
web	Ducks don ' t have their palms read - they look for it on the web .
condition	The boy swallowed a pillow , the hospital described his condition as comfortable .
shop	I nailed my wood - shop test .
try	OLD JUDGES never die , they just cease to try
Ribs	What did the skeleton have for supper ? Ribs .
dive	She was only a Swimmer ' s daughter , but she knew every dive in town . .
Woody	My name is Woody . A Forester
drift	When they bought a water bed , the couple started to drift apart .
Guy	My name is Guy . I install antennas .
opinion	The hardest thing for a person to keep is his opinion
shot	A young nurse was nervous about giving vaccinations but gave it her best shot .
bed	If you tell a falsehood just after waking up you are lying in bed .
rattled	After that poisonous snake struck at me in the Arizona Desert I was really rattled .
law	He shined a police officer ' s shoes and had a brush with the law .
remotely	' Change the channel ' she said remotely .
thought	Then there was the occasion I spotted a health - oriented cafe displaying a sign reading ' ' California Shakes . ' ' Obviously , I thought .
astronomical	The cost of the space program is astronomical .
cultured	People who like yogurt are well cultured .
hit	She played baseball and so did he . They hit it off .
choir	A doorbell salesman joined the choir , and chimed right in .
night	He got measles in jail when he broke out one night .
scales	A fisherman who was also a pianist was an expert with scales .
strain	The melody kept on playing until it became a strain .
striking	The two bowlers bore a striking resemblance .
children	It was a sad day for the rattlesnake family , the time had come for the children to strike out on their own .
console	When I had my PlayStation stolen , my family were there to console me .
figures	Young women who are mathematics professors closely watch their figures .
got	He had trouble in his new job making tents and got himself into a flap .
runs	Poor blood circulation runs through the family .
sentence	If a lawyer speaks for too long there will be an extended sentence .
taste	He was a restaurant critic but had no taste .
serve	Wally wasn ' t sure in which branch of the Army he wanted to serve , but he gravitated toward the paratroops .
knows	I met a math professor who has 12 children - she really knows how to multiply .
fall	My new girlfriend and I are moving together into a tree house , I hope we won ' t fall out .
interest	I used to be a banker but I lost interest
end	OLD PROCTOLOGISTS never die , they just face the end .
brushing	My dentist seems distracted , I think he was brushing me off .
night	We did it twice last night , she relayed .
state	She was only a Governor ' s daughter , but what a state she was in .
guide	On TV it ' s a maze of channels , luckily he had a guide .
push	Doctor , doctor , people tell me I ' m a wheelbarrow . - Don ' t let people push you around . Next .
dying	Never invest in funerals , it ' s a dying industry .
loop	Hangmen always keep their customers in the loop .
NP	Roentgen was radiating .
punch	OLD BOXERS never die , they just punch out
mean	Waiter , there ' s a fly in my soup ! ' ' At our restaurant , we guarantee You won ' t find a single fly . ' ' ' ' Whaddya mean ? ' ' ' ' Because they ' re all married . ' '
fall	Sky divers don ' t jump , they just fall away .
attraction	OLD PLANETS never die , they just lose their attraction .
measure	I wanted to make suits but I could never measure up .
Will	My name is Will , I ' m a lawyer .
advanced	' ' Here ' s your allowance for the next two weeks , ' ' Tom advanced .
shuffle	OLD CARD PLAYERS never die , they just shuffle off .
Eden	The earliest mention of cars is in the Bible when Adam and Eve were driven out of the Garden of Eden .
gets	When a guillotine executioner is layed off he gets severance .
level	I like elevators they let me say jokes on every level .
spirit	OLD ALCOHOLICS never die , they just lose their spirit .
hiding	OLD TANNERS never die they just go into hiding .
harp	Jenny was sure she was going to Heaven but she wouldn ' t harp on it .
answer	In Ireland you ' re more likely to get a Pat answer .
rate	Tires are fixed for a flat rate .
dealt	He was the most dishonest and cleverest card shark in the city , the police said he will be dealt with .
discharged	Old electricians never die , they just get discharged .
jumped	The trampoline was on sale for fifty per cent off . Needless to say I jumped on the offer .
technician	I wanted to be a sonar technician , but it was out of my depth .
lord	Peter went overboard for the lord , why can’t we .
NP	The railway constructions are on track .
prices	Stamp out excessive postage prices .
Art	My name is Art , I ' m a museum curator .
spaced	He put so many blanks in his document that he started to feel spaced out .
told	The mother kangaroo tried to instill good financial habits in her baby . She told him to pocket all his allowance .
concrete	Highways today are much better than they were many years ago and there are lots of concrete examples of it .
foggiest	Don ' t get lost in the mist or else you won ' t have the foggiest idea where you are .
cast	A former doctor , while auditioning for a play , broke his leg . But luckily , he could still make the cast .
married	Some jokes get dated , other jokes get married .
food	I ' ve never tipped a cow . Then again , one has never served me food .
store	Have you heard about that online origami store ? It folded .
NP	She was only an Attorney ' s daughter , but what a will to break .
roped	He didn ' t want to volunteer for the rodeo but he got roped into it .
tack	When he switched from horses to sailing , his life took on a new tack .
plot	I wrote a novel about a fellow who had a small garden . It didn ' t have much of a plot .
prince	The queen told the prince that he was a royal pain .
NP	Hell ! I thought I’d gotten away with it !
moped	' ' I want a motorized bicycle , ' ' Tom moped .
time	A man given a watch at his retirement said ' it ' s about time ' .
candid	Photographers are often very candid people .
sincere	Hell ! I thought it didn ' t matter what you believed as long as you were sincere !
say	A thousand dogs were stolen from a pet shop on Saturday . Police say they have no leads .
universal	Aliens can easily understand each other because their language is universal .
office	At first he was was a sprinter , but then he decided to run for office .
hope	Doctor , Doctor My little boy has just swallowed a roll of film ! - Hmmmm . Let ' s hope nothing develops . Next .
shape	I wondered why my geometry class was always tired . They were all out of shape .
return	We offer counsel so you are not audited on your final return .
still	OLD BOOTLEGGERS never die , they just keep still .
someone	To draw cartoons for a living requires someone who is very animated .
Windows	Bill Gates took advantage of his Windows of opportunity
drawn	I ' m drawn to art .
functions	OLD MATHEMATICIANS never die , they just lose some functions .
party	When you can ' t decide with your friends whose place to have a party at it ' s known as party politics .
convertible	Missionaries like open hooded cars because they are convertible .
hitch	The first time he put the horses on the carriage it went without a hitch .
put	Undertakers ' Motto - Trust us . We are the very last ones to put you down .
wrapped	We are overdressed when we are wrapped up in ourselves .
time	The inventor of sandpaper had a rough time of it .
farther	Satan can’t bring you down any farther than your knees .
element	The inventor of the stove top was in his element .
atmosphere	Astronauts work in a nice atmosphere .
subject	Well drilling is a deep subject .
Candy	My name is Candy . I ' m a confectioner .
moved	This is a picture of my new house , said Tom , visibly moved .
chip	I ' m buying a birthday present for a sculptor . Can you chip in ?
filling	My cavity wasn ' t fixed by my regular dentist , but by a guy who was filling in .
touch	OLD TYPISTS never die , they just lose their touch .
breeze	Installing a fan can be a breeze .
suspended	Skipping school to bungee jump will get you suspended .
key	There is only one way to open the door and that is the key .
buried	OLD GRAVEDIGGERS never die , they just get buried in their work
collect	When the shocked IRS agent was found guilty of tax evasion he had to take time to collect himself .
weasel	The rodent catcher was always trying to weasel his way out of work .
NP	When William joined the army he disliked the phrase ' fire at will ' .
cake	When some coins fell into the batter it turned out to be a rich cake .
police	When the shoe store owner discovered that someone had broken into his store , the police pumped him for information .
cleanly	That ' s the seventh dip , Namaan said cleanly .
odds	Two mathematicians arguing about even numbers were at odds .
umbrella	The weather bureau is an umbrella organization .
disconnected	OLD TELEPHONE OPERATORS never die , they just become disconnected .
quite	A streaker was found dead this morning . Police say the details are quite revealing .
partial	I strongly dislike the subject of math , however I am partial to fractions .
another	The builders of raceways believe that one good turn deserves another .
execution	A computer program attached to an electric chair would have to have its execution checked carefully .
discarded	OLD GAMBLERS never die , they just get discarded .
picking	My mate swallowed a cordless vacuum cleaner , they took him to hospital and he is picking up nicely .
seasoning	My mom ran out of poultry seasoning so she winged it .
expire	OLD CREDIT CARD USERS never die , they just expire .
mislaid	The members of the oldest profession are not really lost women ; they are just mislaid .
strikes	A bowling team was called ' lightning ' because they had so many strikes .
Gene	My name is Gene , I ' m a DNA researcher .
scratch	He had to learn what the measles was , from scratch .
Lute	My name is Lute . I ' m a musician .
broke	She had a boyfriend with a wooden leg , but broke it off .
foiled	One leftover said to another ' foiled again . '
storm	Underpaid weather forecasters predicted a storm of protest .
strokes	The painter was hospitalized due to too many strokes .
count	Trust your calculator . It ' s something to count on .
drugs	When asked by a passenger how high he would get , the pilot replied , ' I don ' t do drugs . '
columns	The journalist went to Greece to see the ancient ruins and is now writing several columns about them .
work	The mortician was late for dinner because he was buried in his work .
grey	OLD RABBIS never die , they just get grey around the temples .
floor	When the janitor wanted to take up public speaking he always had the floor .
unstrung	OLD GUITARISTS never die , they just become unstrung .
stride	The date of the marathon was changed . She took it in stride .
fork	A cutlery manufacturing company was built at a fork in the road .
recovered	The man who fell into an upholstery machine is fully recovered .
dry	People in the desert have dry humor .
Grave	A sign at a cemetery reads , ' No Trespassing , Violators Will Face Grave Charges ' .
dark	For a long time , black holes were a dark secret .
get	She was only a Conductor ' s daughter , but she told you where to get off .
lives	Cooks have a lot of spice in their lives .
incriminate	The defendant in a coffee theft trial refused to testify on the grounds that could incriminate him .
scraps	Dorothy ' s dog , of the Wizard of Oz fame , always eats his food entirely - he never leaves any scraps because it ' s in toto .
weeded	OLD LANDSCAPERS never die , they just get weeded out .
cut	In medical school he worried about passing as a surgeon , but he made the cut .
unravelled	A cat found a mysterious sweater , but the mystery was soon unravelled .
charges	Notice in a field : The farmer allows walkers to cross the field for free , but the bull charges .
passed	I didn ' t have the faintest idea as to why I passed out .
folded	I used to work in a blanket factory but it folded .
dollars	Rental agents offer quarters for dollars .
loved	The environmentalist rode his bike 20 miles in the morning and 20 more in the evening . He loved recycling .
add	His qualifications as a math teacher didn ' t add up .
customers	She was only a Electrician ' s daughter , and she made house calls to remove her customers ' shorts .
Sherry	My name is Sherry . I work in a vineyard .
screwing	How could I trust the ceiling fan installer when I knew he was always screwing up .
playing	A musician went to hospital after playing too many accidentals .
store	If you want a metal dog leash go to a chain store .
competition	If they ever have a contest for the best looking mannequin , there will be stiff competition .
coasters	Set your drink on a skateboard , they make good coasters .
premises	OLD PHILOSOPHERS never die , they just retire to their own premises .
money	People who work at a mint make a lot of money .
went	I wanted to join my local rambling club , but the guy I spoke to on the phone just went on and on .
stoop	She was only a Porchclimber ' s daughter , but you should see her stoop
vision	Have an optometrist run for president , because they are people of vision .
NP	She was only a whisky maker but he loved her still .
work	When the beautician was asked to complete her make - up work she blushed .
blustered	As usual , the chief meteorologist blustered his way through the staff meeting .
disjointed	OLD BUTCHERS never die , they just get disjointed .
session	If you miss a class at beauty school you ' ll need a makeup session .
Bud	My name is Bud . I ' m in flowers .
release	The musician in jail was anxiously awaiting his next release .
time	The man addicted to brake fluid said he could stop any time .
wind	OLD WATCHMAKERS never die , they just wind down .
bits	OLD HACKERS never die , they just go to bits
choked	' ' I ' ve got to stop this motor , ' ' Tom choked .
point	Even the best bird dog is only good to a point .
choppers	OLD HELICOPTER PILOTS never die , they just lose their choppers .
mouse	The cat took up computer lessons in hopes of mastering its grip on a mouse .
experience	Packing up and relocating to a new home can be a moving experience .
hearing	The earless defendant waived his hearing .
capers	The hotel chef was noted for his tomfoolery and his capers .
latitude	Sea captains have a lot of latitude .
circulation	OLD LIBRARIANS never die , they just lose their circulation .
light	Scientists allow us to see the sun in a different light .
grind	Dentists have the same old grind day after day .
late	The star asked the sun why the moon was always up so late . Sun responded that it was just a phase .
paper	Erasable pens were a good idea on paper .
reading	If you do research in optics you will have to do some light reading .
Oscar	My name is Oscar , and I ' m a movie star .
ten	For fast relief take two tablets . The ten commandments
plan	I could not pull out of my parking space , so I used my back up plan .
eggs	Where there are many chickens you can find layers of eggs .
spoiled	A cow that is pampered too much will give spoiled milk .
Pat	When Irish boys carry their little brothers , they get a Pat on the back .
estate	He died leaving 100 clocks . His son is winding up the estate .
kick	He bought a donkey because he thought he might get a kick out of it .
unwind	OLD WATCHMAKERS never die , they just unwind .
landing	Did you hear about the pilot who always had work ? He was great at landing a job .
brush	Do you have any parting words ? - How about comb and brush ?
interest	Two banks with different rates have a conflict of interest .
attached	When crazy glue was invented lots of people became attached to it .
caused	When the wheel was invented , it caused a revolution .
chimed	' ' It ' s twelve noon , ' ' Tom chimed in .
behind	The butcher backed up into the meat grinder and got a little behind in his work .
masochist	Beats me why anyone would want to be a masochist .
heart	OLD CARDIOLOGISTS never die , they just lose heart .
light	After he invented the light bulb , people saw Edison in a new light .
spark	OLD ELECTRICIANS never die , they just lose their spark .
credit	The best way to stop a charging bull is to take away his credit card .
work	I wanted to exercise last night but it just didn ' t work out .
Blind	Some people with a lot of vision started the Blind Institute .
gas	Everyone ' s fuming over the high cost of gas .
proof	She told me the drink was non - alcoholic , but where was the proof ?
backhanded	During a tennis match one player gave the other a backhanded compliment .
blew	He auditioned for a part as a trumpet player but he blew it .
guys	Most males in a men ' s room are stand - up guys .
item	A girl and her boyfriend went to a party as a barcode . They were an item .
contacts	There was an eye doctor who wanted to re - locate but couldn ' t find a job because he didn ' t have enough contacts .
blazes	She was only a Fireman ' s daughter , but she ' s really going to blazes .
Frank	My name is Frank , the Hot - Dog vendor
tired	Last week I was diagnosed with insomnia , and now I ' m just so tired of it .
paper	Musical composers can use lots of Note paper .
short	Small people are in short supply .
incensed	Burning too much incense in a rented room could make the owner incensed .
point	For a fish , the end of a barbed hook is the ' ' point ' ' of no return .
tie	Two silk worms had a race . They ended up in a tie .
decades	Semaphore was flagged away as a form of communication decades ago .
NP	A will is a relative thing .
die	OLD BEEKEEPERS never die they just buzz off .
butcher	I ' d tell you a joke about a cow but I always butcher it .
clothes	There ' s a new magnetic steam iron that makes your clothes attractive .
change	OLD CASHIERS never die , they just change .
bust	The police auction was a complete bust .
wee	The incontinent Scotsman had a wee accident .
unleash	My dog has a lot of potential , you just have to unleash it .
sentence	To some - marriage is a word . . . to others - a sentence .
possibility	Years ago , changing TV channels from a sitting position was a remote possibility .
bit	Horses eat best when they don ' t have a bit in their mouth .
remarked	I ' ve passed the exam this time , Tom remarked .
tables	Waiters are good at multiplication because they know their tables .
listless	When he forgot to itemize what he wanted at the grocery store he felt quite listless .
fine	I got a small ticket for speeding . It ' s fine with me .
dawned	I once had insomnia so bad I was awake until it dawned on me .
sport	Surfing is a swell sport !
baloney	Some food for thought is only baloney
poached	Stolen eggs are poached .
high	Professional rock climbers , the only people paid to get high .
problem	When the doctor asked the editor how he was doing , he said he had a problem with his circulation .
summed	I didn ' t understand the math , so the teacher summed it up for me .
unbelievable	For a dishonest employee : He ' s an unbelievable worker .
get	I wanted to do some research on anorexia , so I went to the library to get the skinny .
peppered	When the spice ships used to bring goods to the king the captain was peppered with compliments .
stop	OLD ORGANISTS never die , they just come to a stop .
getting	The only similarity between ancient times and the 1970 ' s is that both were full of people getting stoned .
pointless	What did the triangle say to the circle ? You ' re so pointless .
harbor	I ' m taking this ship back into harbor , Tom reported .
soft	They call me Pops . I sell soft drinks .
gift	I tried wrapping Christmas presents , but I didn ' t have the gift .
relish	' ' I love hot dogs , ' ' said Tom with relish .
fed	In the army mess hall , the men were getting fed up .
improve	People who eat their apples stem and seed and all improve their core values .
parole	I met this guy who said he loved children , then I found out he was on parole for it .
bar	Piano players know what bar they are in .
ticked	Two clock makers argued and got ticked off .
puzzle	Some people take beautiful pictures and cut them into pieces . That ' s a puzzle to me .
weight	I found out that at the gym , their opinion on fitness carries a lot of weight .
blazes	OLD FIREFIGHTERS never die they just go to blazes .
necessary	When a new baby comes into a family , many changes are necessary .
formalities	The royal pharmacist wore a tuxedo and dispensed with formalities .
hacker	A crazy programmer with a cold is a coughing hacker .
ribbing	Eve taught us it’s okay to take a little ribbing
stars	The astronomer became an actor because he always wanted to visit the stars .
faults	OLD GEOLOGISTS never die , they just have their faults
hang	Meet me at the clothes line . That ' s where I hang out !
pile	The inventor of shag carpet made a big pile .
selfies	I ' ve always pictured myself taking selfies .
follow	He would promise to play golf , but he didn ' t know how to follow through .
draw	The artist was great . He could always draw a crowd .
stick	Glue inventors have to stick to it .
eventually	He made a slow start in the sport of weightlifting but he picked it up eventually .
step	The president of a ladder manufacturer had to step down .
beat	A boiled egg in the morning is hard to beat .
flop	Banning the bra was a big flop .
strike	The general started bowling before his aide had entered his name on the score sheet . He had launched a pre - emptive strike .
shortening	Biscuits and speeches are better when made with shortening .
croak	Biologists have recently produced immortal frogs by removing their vocal cords . They can ' t croak .
matter	Digging a hole for a coffin is a grave matter .
numbers	When the CEO dropped his brownie on the calculator , was he trying to fudge the numbers ?
composed	Noteworthy musicians are very composed .
manufacturers	Stereo speakers are made by ' high volume ' manufacturers .
chops	A karate school restaurant served mainly chops .
drop	For insomnia move to the edge of the bed and you ' ll soon drop off .
saw	He tried to sell me glass with imperfections in it , but I saw through it .
home	Those who make balls of wool for a living like to come home and unwind .
hit	I wondered why the baseball was getting bigger . Then it hit me .
streak	The athlete colored her hair and started a winning streak .
parted	A balding man and his hair are soon parted .
language	Oil executives are always using crude language .
sucked	OLD VACUUM CLEANER SALESMEN never die , they just get sucked in !
draft	When writing out drink recipes you have to have a first draft .
sweet	He worked in a chocolate factory , but always took his sweet time .
pinch	Did you hear about the crab in financial difficulty ? It was starting to feel the pinch .
day	I made a really cheesy pun about quesadillas the other day .
meeting	The organizational get together for a company football team was called a kickoff meeting .
fire	He lit the arrow head because he wanted to fire it .
concentration	' ' Don ' t add too much water , ' ' said Tom with great concentration .
drive	OLD CHAUFFEURS never die they just lose their drive .
idea	Some people still think that writing long stories is a novel idea .
game	Come huddle with us before the big game
pit	She swallowed a peach seed and could feel it in the pit of her stomach .
abstractly	' ' I like modern painting , ' ' said Tom abstractly .
blew	The price of the big fan blew me away .
wash	OLD HOUSEWIVES never die , they just wash away .
heart	The Biomedical Engineer didn ' t have the heart to check the EKG machine .
sage	My stuffing was bad , so I got some sage advice .
gorgeous	Morticians make you feel dead gorgeous .
reforms	The janitor ' s union called for sweeping reforms .
sum	He folded and straightened the money because he wanted a tidy sum .
shot	The boy had never played basketball before so he decided to give it a shot .
delicious	She was only an Apple - grower ' s daughter but the men said she was delicious .
moment	The hostage said he couldn ' t stay on the phone long because he was tied up at the moment .
fire	Bring your spirtual Marshmellows , our pastor is on fire !
came	I tried to look up impotence on the Internet but nothing came up .
fault	The agreeable tennis umpire was generous to a fault .
justification	' ' I like ragged margins , ' ' said Tom without justification .
picture	Old photographers never die , they ' re just out of the picture for a while .
blow	Arguments about the weather will eventually blow over .
casually	' ' I don ' t work here on a regular basis , ' ' said Tom casually .
croak	OLD FROGS never die , but they do croak .
snapped	What are you taking pictures of ? Tom snapped .
dive	Endorsement by an olympic swimmer caused a company ' s profits to dive .
woods	The cannibal passed his brother in the woods .
excitement	Freud could barely repress his excitement .
dictated	My word is final ! Tom dictated to his secretary .
bases	It ' s no wonder that some baseball players have lots of money - often even many of the bases are loaded .
beat	Good police officers never miss a beat .
black	To save money for the company he cut all the electricity . They were soon in the black .
pull	I try wearing tight jeans , but I can never pull it off .
growing	At first I hated my haircut , but now it ' s growing on me .
shirt	What did the minister say to the underdressed layman ? ' ' No shoes , no shirt , no service ' '
scores	A sports match was attended by many scores .
blow	Your very last breath will be a fatal blow .
reproved	I ' ll corroborate that again , Tom reproved .
backed	I had an appointment with the chiropractor , but I backed out .
fledgling	When the baby bird penned his first novel he was just a fledgling author .
joint	Artificial knees and elbows were developed during a joint project .
cells	I always believed my body was a prison for me . I was right , in biology I learnt they were made of cells .
point	I used to hate maths but then I realised decimals have a point .
pitched	OLD BASEBALLS never die they just get pitched .
ERA	The baseball pitcher ' s retirement was at the end of a wonderful ERA .
shocked	The boy who got electrocuted was unable to give a statement because he was still shocked at the incident .
bun	She got fired from the hot dog stand for putting her hair in a bun .
holes	The case against a donut thief was full of holes .
bill	The duck said to the bartender , ' put it on my bill . '
drag	While having a hard time water - skiing , the boy commented , ' This is such a drag . '
block	When the artist tried to draw a cube he had a mental block .
fan	When the air conditioning failed in the indoor stadium there was a fan protest .
mothballed	OLD WOOL COATS never die , they just become mothballed .
mugged	The runaway beer truck barrelled down the freeway after its driver was mugged .
personality	Gauss was asked to attend because of his magnetic personality .
nucleus	A group of physicists is called a nucleus .
shocking	A book called ' Current Trends in Wiring your House ' turned out to be a shocking failure .
loop	A hangman will always keep you in the loop .
conviction	' ' I find you guilty , ' ' said the judge with conviction .
keel	OLD YACHTSMEN never die , they just keel over .
night	She was only a Lighthouse keeper ' s daughter , but she never went out at night
sheep	' ' I will now demonstrate how to dissect a sheep , ' ' delivered Tom .
forms	You have to fill out many government forms because there are many forms of government .
industry	The fertiliser business is a growing industry .
hang	OLD SHEET ROCKERS (dry wallers) never die , they just hang around .
manual	I tried to learn how to drive a stick shift but couldn ' t locate the manual .
discarded	When poker players have to fold they feel a bit discarded .
stuffed	I went to a buffet dinner with my neighbor , who is a taxidermist . After such a big meal , I was stuffed .
demands	Those who iron clothes have a lot of pressing demands .
fit	I think a job as a shoe salesmen would be your best fit .
cut	I kept failing to get a job as a butcher because I couldn ' t just make the cut .
ring	To many girls the word ' marriage ' has a nice ring to it .
stereo	A pair of loud twins were stereo speakers .
peak	To be a mountain climber one needs to be in peak condition .
NP	A bible falling apart belongs to someone who isn’t .
morning	If you work in a tire factory you have to get rolling every morning .
symphony	The trumpeter blew it while auditioning for the symphony .
taken	When a ladder was stolen from a store the manager said that further steps would be taken .
offensive	A high scoring football game can be very offensive .
suck	She was only a Vacuum salesman ' s daughter , but she knew how to suck !
key	If you have need of a locksmith he will be your key man .
style	Massage therapists need a touch of style .
spin	Politicians get onto the merry - go - round and then put a spin on it .
reaction	For a chemist disappointed in an experiment the reaction was on his face .
shop	I was looking for watch batteries but I wound up at a clock shop .
dwelling	Vertical living is flat dwelling .
glass	Waiter , my bill please . - How did you find your luncheon , sir ? - With a magnifying glass .
standing	A lot of kneeling will keep you in good standing
derivative	I just finished reading Newton ' s Principia Mathematica , and found much of it to be rather derivative .
incensed	' ' I ' m burning aromatic substances , ' ' said Tom , incensed .
mad	Upon discovering her children playing with matches their mother was flaming mad .
count	The duke and the count had a fight . The duke was down for the count .
taking	I thought about studying astronomy for university but I knew I would just be taking up space .
sweet	He sold candy and chocolate . A lot of girls were sweet on him .
see	I went to an invisible fairground but didn ' t think it was very good . I just couldn ' t see the attraction .
breeze	One of the joys of being a lightweight is that commuting by wind is a breeze !
NP	My buddy asked me to look after his pet goose while he was away . I told him I wasn ' t down with that .
addresses	OLD PROGRAMMERS never die , they just move to new addresses .
rifle	A speaker at the firearms convention had to rifle through his notes .
twist	Watson and Crick did the twist all night .
pop	Tires cost 100 bucks a pop .
react	OLD CHEMISTS never die , they just fail to react .
flat	Where do pancakes live ? In a flat .
covered	When I asked if I could get insurance if the nearby volcano erupted they assured me I would be covered .
classless	Retired teachers are classless .
feet	She was only a Janitor ' s daughter , and she was often swept off her feet .
pull	OLD DENTISTS never die , they just lose their pull .
board	Lumber companies have many board meetings .
night	Due to inclement weather , the sandwich shop wrapped up early Tuesday night .
point	Sometimes a pencil sharpener is needed in order to make a good point .
Rich	My name is Rich , A successful investment banker .
birdie	A photographer taking pictures of golfers says ' watch the birdie ' .
littering	A dog gave birth to puppies near the road and was ticketed for littering .
home	Those who work on reducing auto emissions go home exhausted .
edge	They bought a home on a cliff because they liked to live on the edge .
pass	Old quarterbacks never die , they just pass away .
attractive	Those who make magnets can be quite attractive .
prime	OLD NUMBER THEORISTS never die , they just get past their prime .
people	The groundskeeper at a large cemetery was important because he had 5000 people under him .
research	There is a growing body of obesity research .
highlight	I tinted my hair today . It was the highlight of my day .
mugging	Stealing someone ' s coffee is called ' mugging ' .
plastered	A doctor drank while putting on patients ' casts . He was soon plastered .
remarked	That ' s the third time my teacher changed my grade , Tom remarked .
karate	I am kicking myself I did not take up karate earlier .
point	Why do archers shoot arrows ? Could it be they are trying to get a point across ?
Internet	Oh what a tangled web we weave . On the Internet .
turn	OLD BUS DRIVERS never die , they just take a turn for the worse .
puppy	I gave in when my wife hounded me about getting a puppy .
interest	Being a fire - fighter ignited my interest heavily .
beat	A boiled egg is hard to beat .
ticked	When Wally discovered he had Lyme disease he was really ticked off .
number	Avogadro expected a large number to attend .
motions	During the meeting about earthquakes , there were several motions .
washed	Those who make sinks often feel washed out .
Cookie	My name is Cookie , I ' m a baker .
butt	OLD PROCTOLOGISTS never die , they just butt out .
plant	He sat in the magician ' s audience dressed as a cactus . He was a plant .
agitating	OLD WASHING MACHINE OPERATORS never die , they just keep agitating .
nailed	I didn ' t know which hammer to get , but I think I nailed it .
touchy	Love can be a touchy subject .
soaked	It was the first time she ' d seen a live sponge on display , and she really soaked it in .
sound	A music store owner has to have sound business practices .
mint	The first guy to mass produce candies made a mint .
cabinets	Old presidents never die they just keep going through their cabinets .
bunk	When they claimed to house two thousand campers , it sounded like a lot of bunk .
shot	He ' d never gone hunting but decided to give it a shot .
Volta	Volta was electrified .
cut	I ' m very picky about my hair , so a strange barber just won ' t cut it .
kicks	Some people go into martial arts just for kicks .
scoop	A reporter was at an ice cream store getting the scoop .
received	Sometimes our Outlook in Life is sent but not received .
clouded	Weather forecasters thinking is sometimes clouded .
milked	Did you hear about the farmer who got attacked by a cow ? He milked it for all it was worth .
figures	OLD BOOKKEEPERS never die they just lose their figures .
dead	Building a cul - de - sac would be a bit of a dead - end job .
scotch	They said he drank 2 bottles of whisky a day , but it wasn ' t true . He had to scotch those rumours right away .
feet	Teacher : In this box , I have a 10 - foot snake . Sammy : You can ' t fool me , Teacher . . . snakes don ' t have feet .
cut	The rabbi became a professional golfer because he was good at making the cut .
immersed	Swimming instructors are always getting immersed in their work .
NP	they stand best who kneel most
argument	' ' It ' s an actual parameter , not a formal parameter , ' ' was Tom ' s argument .
cards	For greeting card companies their fate is in the cards .
summer	A summer is a mathematician .
Mike	My name is Mike . I ' m an announcer
suits	A dry cleaners had a dozen suits in court .
fiddling	Violinists are often fiddling around .
nicely	So , how ' s the flower business going ? Oh , it ' s blossoming quite nicely .
taxing	Working for the IRS is a hard job because it is so taxing .
spirits	A heavy drinker of hard liquor appears to be in high spirits .
deeds	Real estate agents believe in doing good deeds .
insecurities	Securities are the cause of many people ' s insecurities .
home	When the Dalmatian ran away , he was spotted two blocks from home .
Rusty	My name is Rusty , I ' m an iron worker .
think	My student was late for class , claiming he was in the washroom . I think he was stalling .
intoxicating	We should make a beer commercial . It sounds simply intoxicating .
policy	She was only a Insurance broker ' s daughter , but all the guys liked her policy .
sheets	She was only a Bookbinder ' s daughter , but she knew her way between the sheets .
age	OLD ACTUARIES never die they just get broken down by age and sex .
dawn	I love to eat eggs at the crack of dawn .
blowout	Did you hear about the tire dealer that had a blowout sale ?
blustered	' ' This wind is awful , ' ' blustered Tom .
momentum	My new theory on inertia doesn ' t seem to be gaining momentum .
refused	' ' I won ' t buy a circuit breaker , ' ' Tom refused .
pointless	A professor without a pointer may find that his lecture is pointless .
quivering	This is where I keep my arrows , said Tom , quivering .
hit	He realized he ' d made the major leagues when it finally hit him .
fishy	Joe refused to eat sushi because it looks fishy .
rounded	I know a rancher who has 100 head of cattle , but he thought there were only 99 until he rounded them up .
stroke	Leonardo Da Vinci could use a paint brush to make a stroke of genius .
concerned	A jelly truck and a biscuit truck collided yesterday - police are a trifle concerned .
fault	It seems like it ' s always Patsy ' s fault .
bluffed	Sure I can climb cliffs ! Tom bluffed .
hitch	Marriage is hard but divorce usually goes off without a hitch .
good	Those who want to paint polka - dots have to find a good spot .
inflation	Why are all businessmen fat ? Must be all the inflation .
smelt	Iron was discovered because someone smelt it .
transparent	He was trying to sell me new windows , but his motivations were transparent .
resistance	OLD ELECTRICIANS never die , they just lose their resistance .
little	A small boy went to the counter to pay for his lunch but he was a little short .
trunks	It ' s OK to watch an elephant bathe as they usually have their trunks on .
Dusty	My name is Dusty , I run a cleaning service .
landings	If you jump to conclusions , you make terrible landings .
run	If a clock had legs , time would run out .
luck	He always called his girlfriend his ' luck ' . Until he decided to push his luck .
excellent	The All - Pro wide receiver ' s wedding was a little bit shaky , but his reception was excellent .
wing	Audubon said he ' d have to wing it .
marbles	OLD SCULPTORS never die they just lose their marbles .
moonlighting	His day job was astronomy but at night time he was moonlighting .
Cliff	My name is Cliff . I ' m a mountaineer .
twenties	A church welcomed all denominations but preferred tens and twenties .
ruler	If you give some managers an inch they think they ' re a ruler .
erased	OLD WRITERS never die , they just get erased .
pine	OLD FORESTERS never die , they just pine away .
needling	Whenever the nurses have a bad day they just keep needling people .
blue	He became a sky diver out of the blue .
drop	My friend lives by a cliff he ' s always telling me to drop over .
life	He hates his job selling used cars , but it ' s just his lot in life .
track	A racehorse ' s life is always on track .
mulled	I couldn ' t decide whether or not to make spiced apple cider , so I mulled it over .
memory	I can ' t recall the last time I did any running , but I ' ve been jogging my memory .
hanging	People in medieval days were always hanging out by the gallows .
entire	The failure of the third largest manufacturer of baby ' s toys was enough to rattle the entire industry .
Chapter	Neil Simon ' s only unsuccessful play : Chapter 11 .
change	The Transformer always had a lot of quarters with him . He was a big fan of change .
cut	A butcher was trying so hard to be funny , but he just wasn ' t making the cut .
check	OLD CASHIERS never die they just check out .
looked	At seven foot six he was a great basketball player and everyone looked up to him .
drop	Bowling Alley : Please be quiet . We need to hear a pin drop .
scale	The weigh - in at the Sumo wrestling tournament was a large scale effort .
weather	The forecaster was away because he was under the weather .
red	A train load of paint derailed . Nearby businesses were put in the red .
luck	It was a lucky car . Until he had to push his luck .
weight	An elephant ' s opinion carries a lot of weight .
beat	Sign on a music store window : ' Come in and pick out a drum - - then beat it ! '
medicine	My daughter ' s studying natural medicine and I ' m rooting for her .
staged	I went to the theatre , it looked a bit suspicious . I reckon the whole thing was staged .
ticks	He put bug spray on his watch to get rid of the ticks .
trailer	The movie about the mobile home was advertised with a trailer .
cop	Officer Jones takes his yearly bath every June . He is a characteristic example of a dirty cop .
accounting	Life’s a ledger , are we giving a good accounting of ourselves
geared	Employers like their mechanics to be geared up .
family	Home improvement . Take your family to church .
loaded	OLD GUNS never die they just get loaded .
NP	Marconi was not wired up about going .
duke	Two duchesses were arguing about their husbands . They decided to duke it out .
pieces	Pick your friends , but not to pieces
dribbling	OLD SOCCER PLAYERS never die , they just go on dribbling .
shot	After he carried a gun in his car the engine was soon shot .
class	OLD PROFESSORS never die , they just lose their class .
eyes	I can ' t really see myself without eyes .
degrees	The inventor of the fahrenheit scale solved the problem by degrees .
pick	If you don ' t know how to choose music ask a guitarist - they know how to pick .
beat	I bought a metronome for 20 bucks . You can ' t beat that price .
NP	My comb is invaluable - I can ' t part with it .
underground	A city worker who campaigned for new sewer pipes finally had to go underground .
hanging	She told a long story about a coil of rope , and then left us all hanging .
blow	When the tornado went through town it was quite a blow .
cement	The correct formula for concrete is worthwhile to cement in your mind .
Ford	Henry perfected the Ford down to a T .
Fast	Those who choose not to eat , slowly get hungry - - and Fast .
sleep	The guitarist passed out on stage , he must have rocked himself to sleep .
goal	OLD HOCKEY PLAYERS never die , they just achieve their final goal .
wavelength	The two inventors of the radio were on the same wavelength .
brace	For the orthodontist visit , the boy had to brace himself .
point	Decimals have a point .
Warranted	Police can do a search if it ' s Warranted .
screwed	Archimedes set out to invent a water pump and screwed it up .
goal	OLD SOCCER PLAYERS never die , they just achieve their final goal .
catch	There was a sale at the fish market today . I went to see what was the catch .
grapevine	You often hear of a good wine through the grapevine .
Ira	My name is Ira . I ' m an investment advisor .
shady	He was selling palm trees , but people thought it was a shady deal .
trash	Why don ' t people like to talk to garbage men ? They mostly talk trash .
avoid	I usually take steps to avoid elevators .
Iris	My name is Iris . I ' m an optometrist
living	Workers in an upholstery business demanded a wage hike to cushion the high cost of living .
Nick	My name is Nick . I was a barber but I ' m looking for a new job .
deal	The guy who sold his carnival got a Fair deal .
fired	When the human cannonball was late for work he got fired .
plastered	OLD PAINTERS never die they just get plastered .
Carol	My name is Carol . I sing during the holidays .
stick	Always trust a glue salesman . They tend to stick to their word .
buoyant	Archimedes was buoyant at the thought .
takeoff	Two airline pilots in a stand - up comedy did a takeoff .
well	A friend told me he dug a hole in my backyard and filled it with water . I thought he meant well .
Teddy	My name is Teddy , I ' m in lingerie
spring	Gardeners like to spring into action .
turns	Acrobats are always doing good turns .
ventured	' ' I invested in a hi - tech startup , ' ' Tom ventured .
transplants	Patients usually feel better after receiving hand transplants .
shot	Derringer had one shot at fame .
repossessed	If you don ' t pay your exorcist you get repossessed .
hooked	Those who like sport fishing can really get hooked .
bank	If you have to pay to go to the river , we ' d better stop at the bank .
people	You have to give credit to people who work in stores during a holiday - and many people do .
position	Becoming a yoga instructor offers the possibilities of a unique teaching position .
summer	Humpty Dumpty had a great fall - and a pretty good spring and summer , too .
back	The place that made rubber balls almost went bankrupt , but they bounced back .
church	The surest steps to happiness are the steps to church .
instrumental	Soon after he joined the band , the guitarist was instrumental .
legends	OLD GEOGRAPHERS never die , they just become legends .
maintenance	Are giraffes good pets or are they too high maintenance ?
chew	The man who worked in the gum factory fell in a vat of bubblegum . His boss had to chew him out .
suited	She was only a Watchman ' s daughter , but any time suited her .
degrees	Weather forecasters have to have lots of degrees .
waste	OLD SANITATION MEN never die , they just waste away
battery	To become an electrician you have to pass a battery of tests .
played	OLD MUSICIANS never die they just get played out .
think	If you burn the candle on both ends , you’re not as bright as you think .
lame	A student limped into class with a lame excuse .
